_id,report_date,previous_day_total_doses_administered,previous_day_at_least_one,previous_day_fully_vaccinated,previous_day_3doses,total_doses_administered,total_individuals_at_least_one,total_individuals_partially_vaccinated,total_doses_in_fully_vaccinated_individuals,total_individuals_fully_vaccinated,total_individuals_3doses
2820,2021-01-01T00:00:00,6256,6246,2,,32275,32218,32207,22,11,
2821,2021-01-02T00:00:00,4618,4606,6,,36893,36772,36759,26,13,
2822,2021-01-03T00:00:00,5400,5392,4,,42293,42162,42147,30,15,
2823,2021-01-04T00:00:00,5998,5995,0,,48291,48156,48142,28,14,
2824,2021-01-05T00:00:00,9693,9668,21,,57984,57822,57788,68,34,
2825,2021-01-06T00:00:00,12803,12337,451,,70787,70156,69674,964,482,
2826,2021-01-07T00:00:00,16232,15518,700,,87019,85673,84491,2364,1182,
2827,2021-01-08T00:00:00,18052,17034,1005,,105071,102707,100520,4374,2187,
2828,2021-01-09T00:00:00,19522,18441,1068,,124593,121146,117892,6508,3254,
2829,2021-01-10T00:00:00,11380,11338,40,,135973,132475,129182,6586,3293,
2830,2021-01-11T00:00:00,11720,11667,50,,147693,144141,140798,6686,3343,
2831,2021-01-12T00:00:00,14489,14179,301,,162182,158311,154668,7286,3643,
2832,2021-01-13T00:00:00,15451,13822,1598,,177633,172119,166880,10478,5239,
2833,2021-01-14T00:00:00,19204,16748,2439,,196837,188861,181184,15354,7677,
2834,2021-01-15T00:00:00,20099,18040,2039,,216936,206890,197174,19432,9716,
2835,2021-01-16T00:00:00,17128,15941,1173,,234064,222815,211926,21778,10889,
2836,2021-01-17T00:00:00,11275,10031,1237,,245339,232831,220707,24248,12124,
2837,2021-01-18T00:00:00,6809,6724,75,,252148,239531,227336,24390,12195,
2838,2021-01-19T00:00:00,11842,9732,2096,,263990,249242,234951,28582,14291,
2839,2021-01-20T00:00:00,10821,7230,3574,,274811,256449,238585,35728,17864,
2840,2021-01-21T00:00:00,10992,6866,4098,,285803,263299,241337,43924,21962,
2841,2021-01-22T00:00:00,9057,4337,4699,,294860,267599,240940,53318,26659,
2842,2021-01-23T00:00:00,7491,3070,4393,,302351,270639,239588,62102,31051,
2843,2021-01-24T00:00:00,4409,1846,2542,,306760,272467,238874,67186,33593,
2844,2021-01-25T00:00:00,5338,1062,4267,,312098,273497,235638,75718,37859,
2845,2021-01-26T00:00:00,9431,2898,6504,,321529,276363,232001,88724,44362,
2846,2021-01-27T00:00:00,9915,2875,7011,,331444,279209,227837,102744,51372,
2847,2021-01-28T00:00:00,13155,5771,7340,,344599,284947,226235,117424,58712,
2848,2021-01-29T00:00:00,10753,3336,7380,,355352,288252,222161,132182,66091,
2849,2021-01-30T00:00:00,9229,2758,6432,,364581,290967,218448,145038,72519,
2850,2021-01-31T00:00:00,3405,1586,1770,,367986,292519,218231,148576,74288,
2851,2021-02-01T00:00:00,2139,499,1611,,370125,292983,217089,151788,75894,
2852,2021-02-02T00:00:00,4440,1380,3001,,374565,294325,215434,157782,78891,
2853,2021-02-03T00:00:00,6277,1752,4462,,380842,296036,212690,166692,83346,
2854,2021-02-04T00:00:00,9125,1747,7296,,389967,297740,207104,181272,90636,
2855,2021-02-05T00:00:00,8491,1500,6909,,398458,299200,201661,195078,97539,
2856,2021-02-06T00:00:00,10694,1892,8741,,409152,301037,194766,212542,106271,
2857,2021-02-07T00:00:00,7599,1744,5798,,416751,302741,190684,224114,112057,
2858,2021-02-08T00:00:00,8234,3101,5084,,424985,305794,188666,234256,117128,
2859,2021-02-09T00:00:00,15039,3882,11087,,440024,309634,181435,256398,128199,
2860,2021-02-10T00:00:00,15535,4952,10521,,455559,314533,175839,277388,138694,
2861,2021-02-11T00:00:00,16384,3907,12416,,471943,318388,167309,302158,151079,
2862,2021-02-12T00:00:00,17709,2123,15531,,489652,320472,153882,333180,166590,
2863,2021-02-13T00:00:00,16228,2453,13757,,505880,322880,142552,360656,180328,
2864,2021-02-14T00:00:00,12895,931,11930,,518775,323763,131535,384456,192228,
2865,2021-02-15T00:00:00,7875,490,7332,,526650,324205,124671,399068,199534,
2866,2021-02-16T00:00:00,6013,1050,4907,,532663,325212,120794,408836,204418,
2867,2021-02-17T00:00:00,10187,1619,8533,,542850,326787,113864,425846,212923,
2868,2021-02-18T00:00:00,13905,2973,10880,,556755,329712,105939,447546,223773,
2869,2021-02-19T00:00:00,18515,6221,12218,,575270,335881,99921,471920,235960,
2870,2021-02-20T00:00:00,22650,11144,11454,,597920,346962,99586,494752,247376,
2871,2021-02-21T00:00:00,17264,10396,6834,,615184,357298,103130,508336,254168,
2872,2021-02-22T00:00:00,13602,8765,4780,,628786,365994,107095,517798,258899,
2873,2021-02-23T00:00:00,17902,11143,6683,,646688,377081,111535,531092,265546,
2874,2021-02-24T00:00:00,18612,13632,4895,,665300,390657,120258,540798,270399,
2875,2021-02-25T00:00:00,20833,16498,4276,,686133,407089,132462,549254,274627,
2876,2021-02-26T00:00:00,24960,21859,3036,,711093,428888,151262,555252,277626,
2877,2021-02-27T00:00:00,27504,23607,3853,,738597,452431,171000,562862,281431,
2878,2021-02-28T00:00:00,20605,19158,1412,,759202,471535,188734,565602,282801,
2879,2021-03-01T00:00:00,18238,17041,1148,,777440,488514,204612,567804,283902,
2880,2021-03-02T00:00:00,24725,22298,2338,,802165,510751,224557,572388,286194,
2881,2021-03-03T00:00:00,30647,27997,2588,,832812,538697,249948,577498,288749,
2882,2021-03-04T00:00:00,34752,32501,2160,,867564,571131,280273,581716,290858,
2883,2021-03-05T00:00:00,40077,38213,1811,,907641,609296,316661,585270,292635,
2884,2021-03-06T00:00:00,44218,41996,2181,,951859,651237,356462,589550,294775,
2885,2021-03-07T00:00:00,32779,31584,1187,,984638,682747,386843,591808,295904,
2886,2021-03-08T00:00:00,24060,22184,1863,,1008698,704863,407150,595426,297713,
2887,2021-03-09T00:00:00,33359,29901,3430,,1042057,734698,433601,602194,301097,
2888,2021-03-10T00:00:00,38420,34146,4227,,1080477,768770,463494,610552,305276,
2889,2021-03-11T00:00:00,44040,40762,3239,,1124517,809466,501003,616926,308463,
2890,2021-03-12T00:00:00,47772,46053,1695,,1172289,855455,545347,620216,310108,
2891,2021-03-13T00:00:00,58000,55108,2867,,1230289,910492,597571,625842,312921,
2892,2021-03-14T00:00:00,43475,42227,1230,,1273764,952636,638553,628166,314083,
2893,2021-03-15T00:00:00,32837,31136,1683,,1306601,983713,667990,631446,315723,
2894,2021-03-16T00:00:00,54019,51706,2294,,1360620,1035354,717380,635948,317974,
2895,2021-03-17T00:00:00,61141,58590,2505,,1421761,1093878,773449,640858,320429,
2896,2021-03-18T00:00:00,61609,59132,2446,,1483370,1152938,830116,645644,322822,
2897,2021-03-19T00:00:00,64541,61198,3284,,1547911,1214057,888005,652104,326052,
2898,2021-03-20T00:00:00,62648,60042,2570,,1610559,1274043,945469,657148,328574,
2899,2021-03-21T00:00:00,44040,42507,1547,,1654599,1316485,986401,660168,330084,
2900,2021-03-22T00:00:00,31036,30065,981,,1685635,1346462,1015453,662018,331009,
2901,2021-03-23T00:00:00,54683,51898,2734,,1740318,1398265,1064585,667360,333680,
2902,2021-03-24T00:00:00,76517,73326,3144,,1816835,1471501,1134734,673534,336767,
2903,2021-03-25T00:00:00,82993,80400,2542,,1899828,1551822,1212570,678504,339252,
2904,2021-03-26T00:00:00,87091,83544,3508,,1986919,1635285,1292577,685416,342708,
2905,2021-03-27T00:00:00,80941,77978,2878,,2067860,1713160,1367639,691042,345521,
2906,2021-03-28T00:00:00,67053,65452,1564,,2134913,1778522,1431494,694056,347028,
2907,2021-03-29T00:00:00,51783,49086,2656,,2186696,1827528,1477890,699276,349638,
2908,2021-03-30T00:00:00,73661,70236,3359,,2260357,1897686,1544731,705910,352955,
2909,2021-03-31T00:00:00,93238,89567,3601,,2353595,1987155,1630652,713006,356503,
2910,2021-04-01T00:00:00,89413,85515,3854,,2443008,2072572,1712268,720608,360304,
2911,2021-04-02T00:00:00,93187,88947,4219,,2536195,2161433,1796962,728942,364471,
2912,2021-04-03T00:00:00,61056,59367,1739,,2597251,2220709,1854550,732318,366159,
2913,2021-04-04T00:00:00,72372,70705,1658,,2669623,2291303,1923544,735518,367759,
2914,2021-04-05T00:00:00,53763,53281,479,,2723386,2344500,1976310,736380,368190,
2915,2021-04-06T00:00:00,79649,77749,1904,,2803035,2422147,2052107,740080,370040,
2916,2021-04-07T00:00:00,108088,104981,3077,,2911123,2527003,2153944,746118,373059,
2917,2021-04-08T00:00:00,114170,110171,4041,,3025293,2637063,2260019,754088,377044,
2918,2021-04-09T00:00:00,109939,105677,4322,,3135232,2742622,2361321,762602,381301,
2919,2021-04-10T00:00:00,109338,105556,3870,,3244570,2848050,2462945,770210,385105,
2920,2021-04-11T00:00:00,98680,95550,3268,,3343250,2943475,2555161,776628,388314,
2921,2021-04-12T00:00:00,76101,75027,1164,,3419351,3018354,2628944,778820,389410,
2922,2021-04-13T00:00:00,99563,96157,3417,,3518914,3114402,2721623,785558,392779,
2923,2021-04-14T00:00:00,117129,113346,3663,,3636043,3227630,2831228,792804,396402,
2924,2021-04-15T00:00:00,113641,109558,3914,,3749684,3337062,2936803,800518,400259,
2925,2021-04-16T00:00:00,118157,113755,4216,,3867841,3450707,3046276,808862,404431,
2926,2021-04-17T00:00:00,112489,107876,4466,,3980330,3558449,3149611,817676,408838,
2927,2021-04-18T00:00:00,88810,86547,2124,,4069140,3644873,3233965,821816,410908,
2928,2021-04-19T00:00:00,69016,67468,1463,,4138156,3712211,3299891,824640,412320,
2929,2021-04-20T00:00:00,102185,98831,3142,,4240341,3810880,3395483,830794,415397,
2930,2021-04-21T00:00:00,142150,137829,4079,,4382491,3948535,3529127,838816,419408,
2931,2021-04-22T00:00:00,139598,135404,3939,,4522089,4083810,3660519,846582,423291,
2932,2021-04-23T00:00:00,138311,131841,6216,,4660400,4215497,3786048,858898,429449,
2933,2021-04-24T00:00:00,130382,126287,3917,,4790782,4341636,3908326,866620,433310,
2934,2021-04-25T00:00:00,102074,98640,3196,,4892856,4440128,4003689,872878,436439,
2935,2021-04-26T00:00:00,71040,69320,1567,,4963896,4509317,4071371,875892,437946,
2936,2021-04-27T00:00:00,98578,95462,2915,,5062474,4604618,4163820,881596,440798,
2937,2021-04-28T00:00:00,120656,116002,4451,,5183130,4720452,4275275,890354,445177,
2938,2021-04-29T00:00:00,124584,119339,5080,,5307714,4839624,4389436,900376,450188,
2939,2021-04-30T00:00:00,115913,110617,5043,,5423627,4950068,4494914,910308,455154,
2940,2021-05-01T00:00:00,111380,107479,3676,,5535007,5057366,4598613,917506,458753,
2941,2021-05-02T00:00:00,79198,76203,2880,,5614205,5133412,4671845,923134,461567,
2942,2021-05-03T00:00:00,56820,55144,1599,,5671025,5188401,4725295,926212,463106,
2943,2021-05-04T00:00:00,92009,88606,3315,,5763034,5276829,4810485,932688,466344,
2944,2021-05-05T00:00:00,138086,133358,4634,,5901120,5410018,4939103,941830,470915,
2945,2021-05-06T00:00:00,141918,136936,4838,,6043038,5546770,5071079,951382,475691,
2946,2021-05-07T00:00:00,150374,145305,4858,,6193412,5691915,5211425,960980,480490,
2947,2021-05-08T00:00:00,142572,137846,4469,,6335984,5829565,5344685,969760,484880,
2948,2021-05-09T00:00:00,124908,121224,3508,,6460892,5950625,5462301,976648,488324,
2949,2021-05-10T00:00:00,97866,95854,1900,,6558758,6046290,5556133,980314,490157,
2950,2021-05-11T00:00:00,113626,108920,4510,,6672384,6155008,5660412,989192,494596,
2951,2021-05-12T00:00:00,145145,138076,6909,,6817529,6292905,5791466,1002878,501439,
2952,2021-05-13T00:00:00,142825,135395,7257,,6960354,6428125,5919503,1017244,508622,
2953,2021-05-14T00:00:00,148945,138837,9935,,7109299,6566774,6048282,1036984,518492,
2954,2021-05-15T00:00:00,159843,149758,9899,,7269142,6716345,6188029,1056632,528316,
2955,2021-05-16T00:00:00,144453,136163,8076,,7413595,6852340,6316028,1072624,536312,
2956,2021-05-17T00:00:00,115053,110945,3954,,7528648,6963096,6422906,1080380,540190,
2957,2021-05-18T00:00:00,111441,100550,10681,,7640089,7063450,6512641,1101618,550809,
2958,2021-05-19T00:00:00,149979,133537,16257,,7790068,7196835,6629843,1133984,566992,
2959,2021-05-20T00:00:00,151697,131674,19794,,7941765,7328320,6741603,1173434,586717,
2960,2021-05-21T00:00:00,165524,140980,24275,,8107289,7469119,6858204,1221830,610915,
2961,2021-05-22T00:00:00,199593,172354,26998,,8306882,7641275,7003443,1275664,637832,
2962,2021-05-23T00:00:00,139939,127531,12250,,8446821,7768628,7118608,1300040,650020,
2963,2021-05-24T00:00:00,100359,93372,6835,,8547180,7861827,7205042,1313570,656785,
2964,2021-05-25T00:00:00,90580,83066,7292,,8637760,7944730,7280720,1328020,664010,
2965,2021-05-26T00:00:00,139922,113107,26538,,8777682,8057650,7367172,1380956,690478,
2966,2021-05-27T00:00:00,152162,123117,28792,,8929844,8180610,7461409,1438402,719201,
2967,2021-05-28T00:00:00,163983,132397,31272,,9093827,8312833,7562420,1500826,750413,
2968,2021-05-29T00:00:00,153498,117201,36062,,9247325,8429884,7643465,1572838,786419,
2969,2021-05-30T00:00:00,149817,119092,30489,,9397142,8548806,7731960,1633692,816846,
2970,2021-05-31T00:00:00,99283,79875,19212,,9496425,8628511,7792517,1671988,835994,
2971,2021-06-01T00:00:00,124297,90687,33265,,9620722,8719003,7849819,1738368,869184,
2972,2021-06-02T00:00:00,145435,102230,42942,,9766157,8821050,7908995,1824110,912055,
2973,2021-06-03T00:00:00,155495,100000,55210,,9921652,8920865,7953671,1934388,967194,
2974,2021-06-04T00:00:00,181857,115625,65948,,10103509,9036291,8003237,2066108,1033054,
2975,2021-06-05T00:00:00,172163,103530,68341,,10275672,9139622,8038313,2202618,1101309,
2976,2021-06-06T00:00:00,163498,91941,71270,,10439170,9231385,8058876,2345018,1172509,
2977,2021-06-07T00:00:00,119636,63108,56310,,10558806,9294296,8065552,2457488,1228744,
2978,2021-06-08T00:00:00,161999,72522,89027,,10720805,9366629,8048938,2635382,1317691,
2979,2021-06-09T00:00:00,181597,70893,110222,,10902402,9437345,8009513,2855664,1427832,
2980,2021-06-10T00:00:00,185724,66502,118721,,11088126,9503644,7957182,3092924,1546462,
2981,2021-06-11T00:00:00,204933,67598,136560,,11293059,9571056,7888116,3365880,1682940,
2982,2021-06-12T00:00:00,199899,62768,136514,,11492958,9633643,7814281,3638724,1819362,
2983,2021-06-13T00:00:00,190457,58977,130938,,11683415,9692445,7742225,3900440,1950220,
2984,2021-06-14T00:00:00,137750,38732,98611,,11821165,9730981,7682255,4097452,2048726,
2985,2021-06-15T00:00:00,189674,42693,146614,,12010839,9773455,7578212,4390486,2195243,
2986,2021-06-16T00:00:00,206375,42498,163218,,12217214,9815757,7457399,4716716,2358358,
2987,2021-06-17T00:00:00,210620,38015,172003,,12427834,9853557,7323288,5060538,2530269,
2988,2021-06-18T00:00:00,217331,35433,181277,,12645165,9888800,7177346,5422908,2711454,
2989,2021-06-19T00:00:00,216037,35563,179784,,12861202,9924156,7033030,5782252,2891126,
2990,2021-06-20T00:00:00,186382,35636,150165,,13047584,9959594,6918411,6082366,3041183,
2991,2021-06-21T00:00:00,120528,20886,99130,,13168112,9980285,6840064,6280442,3140221,
2992,2021-06-22T00:00:00,205105,27617,176717,,13373217,10007708,6690879,6633658,3316829,
2993,2021-06-23T00:00:00,230706,28715,201226,,13603923,10036223,6518276,7035894,3517947,
2994,2021-06-24T00:00:00,227845,26752,200316,,13831768,10062779,6344626,7436306,3718153,
2995,2021-06-25T00:00:00,251277,28065,222446,,14083045,10090642,6150162,7880960,3940480,
2996,2021-06-26T00:00:00,261485,30107,230655,,14344530,10120523,5949529,8341988,4170994,
2997,2021-06-27T00:00:00,205142,27877,176647,,14549672,10148219,5800687,8695064,4347532,
2998,2021-06-28T00:00:00,199339,20998,177766,,14749011,10169019,5643846,9050346,4525173,
2999,2021-06-29T00:00:00,250238,24548,224941,,14999249,10193326,5443366,9499920,4749960,
3000,2021-06-30T00:00:00,275687,24244,250869,,15274936,10217367,5216667,10001400,5000700,
3001,2021-07-01T00:00:00,272099,25362,246173,,15547035,10242510,4995777,10493466,5246733,
3002,2021-07-02T00:00:00,144842,11637,132956,,15691877,10253972,4874385,10759174,5379587,
3003,2021-07-03T00:00:00,217038,19988,196806,,15908915,10273738,4697494,11152488,5576244,
3004,2021-07-04T00:00:00,196424,19603,176583,,16105339,10293154,4540447,11505414,5752707,
3005,2021-07-05T00:00:00,148786,12477,136159,,16254125,10305441,4416703,11777476,5888738,
3006,2021-07-06T00:00:00,220150,20047,199871,,16474275,10325272,4236809,12176926,6088463,
3007,2021-07-07T00:00:00,246728,23018,223446,,16721003,10348064,4036303,12623522,6311761,
3008,2021-07-08T00:00:00,231361,21438,209694,,16952364,10369296,3847976,13042640,6521320,
3009,2021-07-09T00:00:00,227109,21557,205371,,17179473,10390651,3664092,13453118,6726559,
3010,2021-07-10T00:00:00,209164,20575,188422,,17388637,10411022,3496178,13829688,6914844,
3011,2021-07-11T00:00:00,171752,17609,154010,,17560389,10428430,3359723,14137414,7068707,
3012,2021-07-12T00:00:00,123198,11471,111622,,17683587,10439712,3259520,14360384,7180192,
3013,2021-07-13T00:00:00,178669,19123,159390,,17862256,10458612,3119186,14678852,7339426,
3014,2021-07-14T00:00:00,180132,19349,160616,,18042388,10477746,2977867,14999758,7499879,
3015,2021-07-15T00:00:00,167312,19633,147498,,18209700,10497168,2849955,15294426,7647213,
3016,2021-07-16T00:00:00,169483,19965,149352,,18379183,10516931,2720519,15592824,7796412,
3017,2021-07-17T00:00:00,173170,20362,152667,,18552353,10537044,2588157,15897774,7948887,
3018,2021-07-18T00:00:00,133749,15985,117617,,18686102,10552845,2486489,16132712,8066356,
3019,2021-07-19T00:00:00,92059,10448,81495,,18778161,10563080,2415404,16295352,8147676,
3020,2021-07-20T00:00:00,133647,17010,116576,,18911808,10579850,2315774,16528152,8264076,
3021,2021-07-21T00:00:00,140181,17031,123069,,19051989,10596666,2209683,16773966,8386983,
3022,2021-07-22T00:00:00,125764,17735,107888,,19177753,10614177,2119483,16989388,8494694,
3023,2021-07-23T00:00:00,120399,17048,103129,,19298152,10630984,2033360,17195248,8597624,
3024,2021-07-24T00:00:00,126807,18386,108177,,19424959,10649167,1943529,17411276,8705638,
3025,2021-07-25T00:00:00,103761,14931,88692,,19528720,10663874,1869725,17588298,8794149,
3026,2021-07-26T00:00:00,66768,9936,56737,,19595488,10673593,1822887,17701412,8850706,
3027,2021-07-27T00:00:00,92488,15364,76966,,19687976,10688696,1761241,17854910,8927455,
3028,2021-07-28T00:00:00,94063,16529,77460,,19782039,10704990,1700266,18009448,9004724,
3029,2021-07-29T00:00:00,89547,16788,72592,,19871586,10721546,1644418,18154256,9077128,
3030,2021-07-30T00:00:00,84198,16167,67908,,19955784,10737485,1592637,18289696,9144848,
3031,2021-07-31T00:00:00,84010,15798,68058,,20039794,10753065,1540349,18425432,9212716,
3032,2021-08-01T00:00:00,61965,11368,50413,,20101759,10764207,1501269,18525876,9262938,
3033,2021-08-02T00:00:00,42577,7461,34988,,20144336,10771469,1473710,18595518,9297759,
3034,2021-08-03T00:00:00,33397,6016,27198,,20177733,10777252,1452505,18649494,9324747,
3035,2021-08-04T00:00:00,61439,12431,48810,,20239172,10789447,1416088,18746718,9373359,
3036,2021-08-05T00:00:00,59549,12601,46787,,20298721,10801840,1381858,18839964,9419982,
3037,2021-08-06T00:00:00,56123,11908,43996,,20354844,10813488,1349739,18927498,9463749,
3038,2021-08-07T00:00:00,62469,12185,50087,,20417313,10825412,1311794,19027236,9513618,
3039,2021-08-08T00:00:00,48843,9357,39279,,20466156,10834541,1281849,19105384,9552692,
3040,2021-08-09T00:00:00,30935,5975,24771,,20497091,10840302,1263026,19154552,9577276,
3041,2021-08-10T00:00:00,49385,10578,38491,,20546476,10850600,1235079,19231042,9615521,
3042,2021-08-11T00:00:00,48817,10814,37744,,20595293,10861168,1208118,19306100,9653050,
3043,2021-08-12T00:00:00,49376,11267,37866,,20644669,10872183,1181477,19381412,9690706,
3044,2021-08-13T00:00:00,49732,11789,37661,,20694401,10883731,1155575,19456312,9728156,
3045,2021-08-14T00:00:00,51335,12200,38921,,20745736,10895681,1128828,19533706,9766853,
3046,2021-08-15T00:00:00,41880,9903,31741,,20787616,10905382,1106960,19596844,9798422,
3047,2021-08-16T00:00:00,26816,6227,20433,,20814432,10911386,1092728,19637316,9818658,
3048,2021-08-17T00:00:00,40630,11121,29225,,20855062,10922257,1074600,19695314,9847657,
3049,2021-08-18T00:00:00,41999,12024,29725,,20897061,10934039,1056867,19754344,9877172,
3050,2021-08-19T00:00:00,46008,16609,29142,,20943069,10950397,1044306,19812182,9906091,
3051,2021-08-20T00:00:00,46567,16365,29786,,20989636,10966506,1030858,19871296,9935648,
3052,2021-08-21T00:00:00,48049,15200,32485,,21037685,10981446,1013540,19935812,9967906,
3053,2021-08-22T00:00:00,34514,10870,23363,,21072199,10992069,1001023,19982092,9991046,
3054,2021-08-23T00:00:00,23253,7022,16008,,21095452,10998856,992016,20013680,10006840,
3055,2021-08-24T00:00:00,37744,13416,23858,,21133196,11012018,981551,20060934,10030467,
3056,2021-08-25T00:00:00,41487,14484,26376,,21174683,11026246,969640,20113212,10056606,
3057,2021-08-26T00:00:00,39374,13606,25009,,21214057,11039576,958202,20162748,10081374,
3058,2021-08-27T00:00:00,37804,13008,23735,,21251861,11052343,947448,20209790,10104895,
3059,2021-08-28T00:00:00,40263,13487,25567,,21292124,11065551,935344,20260414,10130207,
3060,2021-08-29T00:00:00,30651,10283,19986,,21322775,11075602,925622,20299960,10149980,
3061,2021-08-30T00:00:00,18291,6162,11866,,21341066,11081517,919889,20323256,10161628,
3062,2021-08-31T00:00:00,32793,11973,19660,,21373859,11093222,912174,20362096,10181048,
3063,2021-09-01T00:00:00,36396,13018,22018,,21410255,11106007,903158,20405698,10202849,
3064,2021-09-02T00:00:00,37914,15701,19728,,21448169,11121456,899106,20444700,10222350,
3065,2021-09-03T00:00:00,47021,21155,22496,,21495190,11142362,897746,20489232,10244616,
3066,2021-09-04T00:00:00,46993,20632,24833,,21542183,11162748,893522,20538452,10269226,
3067,2021-09-05T00:00:00,33173,14245,18623,,21575356,11176749,889124,20575250,10287625,
3068,2021-09-06T00:00:00,21792,9519,12068,,21597148,11186019,886558,20598922,10299461,
3069,2021-09-07T00:00:00,15115,6779,8142,,21612263,11192541,885178,20614726,10307363,
3070,2021-09-08T00:00:00,41276,17178,20989,,21653539,11209455,881349,20656212,10328106,
3071,2021-09-09T00:00:00,41602,17049,19741,,21695141,11226227,878632,20695190,10347595,
3072,2021-09-10T00:00:00,39800,15577,19074,,21734941,11241541,875117,20732848,10366424,
3073,2021-09-11T00:00:00,42503,15997,23385,,21777444,11257259,867708,20779102,10389551,
3074,2021-09-12T00:00:00,30063,11562,17920,,21807507,11268527,861320,20814414,10407207,
3075,2021-09-13T00:00:00,16136,6419,9208,,21823643,11274712,858516,20832392,10416196,
3076,2021-09-14T00:00:00,29998,11590,15337,,21853641,11285999,854742,20862514,10431257,
3077,2021-09-15T00:00:00,39378,14057,19477,,21893019,11299796,849306,20900980,10450490,
3078,2021-09-16T00:00:00,39452,14040,19284,,21932471,11313601,844039,20939124,10469562,
3079,2021-09-17T00:00:00,39069,13675,19406,,21971540,11327034,838296,20977476,10488738,
3080,2021-09-18T00:00:00,41397,14142,23620,,22012937,11340903,828797,21024212,10512106,
3081,2021-09-19T00:00:00,30741,10854,19026,,22043678,11351497,820612,21061770,10530885,
3082,2021-09-20T00:00:00,16772,6114,10193,,22060450,11357356,816510,21081692,10540846,
3083,2021-09-21T00:00:00,31458,11250,17041,,22091908,11368341,810703,21115276,10557638,
3084,2021-09-22T00:00:00,41900,14848,22971,,22133808,11382893,802559,21160668,10580334,
3085,2021-09-23T00:00:00,47309,16159,26070,,22181117,11398787,792629,21212316,10606158,
3086,2021-09-24T00:00:00,46462,15682,26746,,22227579,11414209,781546,21265326,10632663,
3087,2021-09-25T00:00:00,48309,15297,30002,,22275888,11429253,766822,21324862,10662431,
3088,2021-09-26T00:00:00,37620,12458,24552,,22313508,11441436,754707,21373458,10686729,
3089,2021-09-27T00:00:00,19204,6547,12344,,22332712,11447729,748894,21397670,10698835,
3090,2021-09-28T00:00:00,31064,11327,17944,,22363776,11458797,742265,21433064,10716532,
3091,2021-09-29T00:00:00,37990,12509,21781,,22401766,11471035,732973,21476124,10738062,
3092,2021-09-30T00:00:00,37457,11686,21437,,22439223,11482462,723203,21518518,10759259,
3093,2021-10-01T00:00:00,30995,9847,18471,,22470218,11492082,714566,21555032,10777516,
3094,2021-10-02T00:00:00,37222,11180,23633,,22507440,11502992,702095,21601794,10800897,
3095,2021-10-03T00:00:00,27257,8179,18352,,22534697,11510930,691909,21638042,10819021,
3096,2021-10-04T00:00:00,14892,4754,9813,,22549589,11515436,686832,21657208,10828604,
3097,2021-10-05T00:00:00,26951,8639,15943,,22576540,11523814,679513,21688602,10844301,
3098,2021-10-06T00:00:00,31797,9667,18601,,22608337,11533222,670571,21725302,10862651,
3099,2021-10-07T00:00:00,30439,9428,17159,,22638776,11542399,662827,21759144,10879572,
3100,2021-10-08T00:00:00,32953,10788,18902,,22671729,11552916,654699,21796434,10898217,
3101,2021-10-09T00:00:00,34251,10693,21083,,22705980,11563346,644295,21838102,10919051,
3102,2021-10-10T00:00:00,23484,7680,15128,,22729464,11570775,636835,21867880,10933940,
3103,2021-10-11T00:00:00,12050,3852,7889,,22741514,11574377,632782,21883190,10941595,
3104,2021-10-12T00:00:00,5218,1662,3329,,22746732,11575761,631100,21889322,10944661,
3105,2021-10-13T00:00:00,29210,9223,18141,,22775942,11584693,622166,21925054,10962527,
3106,2021-10-14T00:00:00,29087,8924,17795,,22805029,11593340,613285,21960110,10980055,
3107,2021-10-15T00:00:00,29207,8864,18227,,22834236,11601941,603909,21996064,10998032,
3108,2021-10-16T00:00:00,31209,9011,19904,,22865445,11610661,593004,22035314,11017657,
3109,2021-10-17T00:00:00,23783,7272,15420,,22889228,11617678,584843,22065670,11032835,
3110,2021-10-18T00:00:00,12339,3753,8167,,22901567,11621150,580417,22081466,11040733,
3111,2021-10-19T00:00:00,21373,6657,12692,,22922940,11627524,574369,22106310,11053155,
3112,2021-10-20T00:00:00,25747,7557,14964,,22948687,11634834,566949,22135770,11067885,
3113,2021-10-21T00:00:00,23273,6708,13081,,22971960,11641273,560565,22161416,11080708,
3114,2021-10-22T00:00:00,26213,7340,15168,,22998173,11648290,552721,22191138,11095569,
3115,2021-10-23T00:00:00,28273,7625,17209,,23026446,11655653,543130,22225046,11112523,
3116,2021-10-24T00:00:00,19431,5741,12642,,23045877,11661138,536217,22249842,11124921,
3117,2021-10-25T00:00:00,9956,2716,6489,,23055833,11663585,532436,22262298,11131149,
3118,2021-10-26T00:00:00,19006,5415,11153,,23074839,11668722,526689,22284066,11142033,
3119,2021-10-27T00:00:00,22946,6097,13262,,23097785,11674564,519510,22310108,11155054,
3120,2021-10-28T00:00:00,22390,5812,12684,,23120175,11680088,512627,22334922,11167461,
3121,2021-10-29T00:00:00,22909,5751,13103,,23143084,11685537,505260,22360554,11180277,
3122,2021-10-30T00:00:00,24227,6075,14667,,23167311,11691340,496656,22389368,11194684,
3123,2021-10-31T00:00:00,16547,4611,10639,,23183858,11695657,490623,22410068,11205034,
3124,2021-11-01T00:00:00,7906,2092,5067,,23191764,11697469,487635,22419668,11209834,
3125,2021-11-02T00:00:00,15681,4377,7775,,23207445,11701557,484226,22434662,11217331,
3126,2021-11-03T00:00:00,18704,5086,9645,,23226149,11706340,479657,22453366,11226683,
3127,2021-11-04T00:00:00,19574,4893,10070,,23245723,11710957,474465,22472984,11236492,
3128,2021-11-05T00:00:00,21528,4419,9554,,23267251,11715087,469316,22491542,11245771,
3129,2021-11-06T00:00:00,25400,5227,12181,,23292651,11720045,462345,22515400,11257700,
3130,2021-11-07T00:00:00,21515,4041,8960,,23314166,11723805,457414,22532782,11266391,
3131,2021-11-08T00:00:00,12008,2114,4743,,23326174,11725624,454769,22541710,11270855,
3132,2021-11-09T00:00:00,24211,3874,7696,,23350385,11729177,450937,22556480,11278240,
3133,2021-11-10T00:00:00,28569,4532,9051,,23378954,11733433,446404,22574058,11287029,
3134,2021-11-11T00:00:00,28853,4333,9145,,23407807,11737469,441583,22591772,11295886,
3135,2021-11-12T00:00:00,26864,4194,8309,,23434671,11741372,437454,22607836,11303918,
3136,2021-11-13T00:00:00,34407,5099,11461,,23469078,11746165,431083,22630164,11315082,
3137,2021-11-14T00:00:00,23280,3910,8639,,23492358,11749812,426347,22646930,11323465,
3138,2021-11-15T00:00:00,12740,2199,4510,,23505098,11751751,424028,22655446,11327723,
3139,2021-11-16T00:00:00,26272,3951,7538,,23531370,11755446,420437,22670018,11335009,
3140,2021-11-17T00:00:00,31246,4062,7863,,23562616,11759226,416626,22685200,11342600,
3141,2021-11-18T00:00:00,32590,3882,7569,,23595206,11762801,412925,22699752,11349876,
3142,2021-11-19T00:00:00,35553,3879,7789,,23630759,11766379,409003,22714752,11357376,
3143,2021-11-20T00:00:00,40196,4399,8857,,23670955,11770496,404536,22731920,11365960,
3144,2021-11-21T00:00:00,28193,3451,6990,,23699148,11773685,400983,22745404,11372702,
3145,2021-11-22T00:00:00,14941,1957,3913,,23714089,11775365,399021,22752688,11376344,
3146,2021-11-23T00:00:00,33145,3294,6054,,23747234,11778379,396253,22764252,11382126,
3147,2021-11-24T00:00:00,42758,3781,6851,,23789992,11781855,393172,22777366,11388683,
3148,2021-11-25T00:00:00,46145,3955,6630,,23836137,11785535,390494,22790082,11395041,
3149,2021-11-26T00:00:00,52947,11370,6656,,23889084,11796634,395201,22802866,11401433,
3150,2021-11-27T00:00:00,63621,22379,7080,,23952705,11818732,410490,22816484,11408242,
3151,2021-11-28T00:00:00,51522,27758,5349,,24004227,11846198,432887,22826622,11413311,
3152,2021-11-29T00:00:00,33551,18935,2896,,24037778,11864872,448915,22831914,11415957,
3153,2021-11-30T00:00:00,56145,20715,5184,,24093923,11885306,464436,22841740,11420870,
3154,2021-12-01T00:00:00,69633,26264,5684,,24163556,11911264,485002,22852524,11426262,
3155,2021-12-02T00:00:00,71719,26507,5075,,24235275,11937473,506421,22862104,11431052,
3156,2021-12-03T00:00:00,73542,25124,5229,,24308817,11962301,526310,22871982,11435991,
3157,2021-12-04T00:00:00,81280,27815,6131,47313,24390097,11989822,547985,,11441837,808577
3158,2021-12-05T00:00:00,62703,31948,4445,26287,24452800,12021475,575480,,11445995,834760
3159,2021-12-06T00:00:00,38657,19156,2723,16761,24491457,12040341,591906,,11448435,851443
3160,2021-12-07T00:00:00,60378,14866,4531,40962,24551835,12054935,602231,,11452704,892331
3161,2021-12-08T00:00:00,73557,19081,4719,49749,24625392,12073739,616583,,11457156,942002
3162,2021-12-09T00:00:00,74579,18295,4375,51890,24699971,12091725,630495,,11461230,993807
3163,2021-12-10T00:00:00,77621,17604,4707,55294,24777592,12109048,643387,,11465661,1049020
3164,2021-12-11T00:00:00,83312,20428,5894,56974,24860904,12129187,657907,,11471280,1105908
3165,2021-12-12T00:00:00,60836,22712,4193,33888,24921740,12151619,676420,,11475199,1139707
3166,2021-12-13T00:00:00,34983,11605,2435,20919,24956723,12162928,685580,,11477348,1160531
3167,2021-12-14T00:00:00,102088,9021,3902,89112,25058811,12171638,690684,,11480954,1249523
3168,2021-12-15T00:00:00,127804,12454,4554,110756,25186615,12183788,698574,,11485214,1360179
3169,2021-12-16T00:00:00,139482,12487,4288,122683,25326097,12195989,706763,,11489226,1482763
3170,2021-12-17T00:00:00,159285,12421,4561,142278,25485382,12208135,714614,,11493521,1624944
3171,2021-12-18T00:00:00,175690,13537,4960,157147,25661072,12221379,723179,,11498200,1781997
3172,2021-12-19T00:00:00,140502,18165,3959,118339,25801574,12239243,737377,,11501866,1900225
3173,2021-12-20T00:00:00,106876,10313,2758,93753,25908450,12249288,744922,,11504366,1993880
3174,2021-12-21T00:00:00,215517,12976,4356,198156,26123967,12261948,753535,,11508413,2191915
3175,2021-12-22T00:00:00,237404,14445,5242,217826,26361371,12276093,762724,,11513369,2409623
3176,2021-12-23T00:00:00,257906,11751,5128,240919,26619277,12287537,769341,,11518196,2650436
3177,2021-12-24T00:00:00,223759,9476,4623,209588,26843036,12296715,774190,,11522525,2859907
3178,2021-12-25T00:00:00,89808,3903,2542,83374,26932844,12300343,775546,,11524797,2943174
3179,2021-12-26T00:00:00,11918,391,367,11148,26944762,12300442,775562,,11524880,2954192
3180,2021-12-27T00:00:00,46991,1494,1134,44330,26991753,12301691,775915,,11525776,2998402
3181,2021-12-28T00:00:00,144877,6113,4039,134658,27136630,12307510,777978,,11529532,3132929
3182,2021-12-29T00:00:00,175566,9390,4622,161483,27312196,12316603,782742,,11533861,3294284
3183,2021-12-30T00:00:00,200176,10151,5384,184592,27512372,12326451,787494,,11538957,3478742
3184,2021-12-31T00:00:00,195338,10027,5846,179207,27707710,12336189,791666,,11544523,3657823
3185,2022-01-01T00:00:00,97039,5404,3918,87389,27804749,12341283,793144,,11548139,3745063
3186,2022-01-02T00:00:00,19483,949,948,17454,27824232,12341941,793136,,11548805,3762371
3187,2022-01-03T00:00:00,88293,4779,4602,78830,27912525,12346410,793305,,11553105,3841048
3188,2022-01-04T00:00:00,146515,6059,5353,135056,28059040,12352141,793998,,11558143,3975948
3189,2022-01-05T00:00:00,177684,7702,7346,162459,28236724,12359489,794343,,11565146,4138247
3190,2022-01-06T00:00:00,191691,7258,6821,177074,28428415,12366428,794769,,11571659,4315166
3191,2022-01-07T00:00:00,191480,8028,7046,175578,28619895,12374112,795739,,11578373,4490571
3192,2022-01-08T00:00:00,181864,8694,6694,165287,28801759,12382474,797726,,11584748,4655702
3193,2022-01-09T00:00:00,131203,9904,7220,113984,28932962,12392056,800405,,11591651,4769526
3194,2022-01-10T00:00:00,90616,5117,4501,80863,29023578,12396850,801011,,11595839,4850236
3195,2022-01-11T00:00:00,139073,6212,6642,125509,29162651,12402715,800568,,11602147,4975555
3196,2022-01-12T00:00:00,157205,8210,8109,138760,29319856,12410596,800664,,11609932,5114147
3197,2022-01-13T00:00:00,162821,9242,9249,141610,29482677,12419476,800643,,11618833,5255574
3198,2022-01-14T00:00:00,160055,10799,10435,136123,29642732,12429913,801002,,11628911,5391499
3199,2022-01-15T00:00:00,161343,11039,11714,135955,29804075,12440580,800316,,11640264,5527261
3200,2022-01-16T00:00:00,109895,9324,9719,89488,29913970,12449542,799914,,11649628,5616531
3201,2022-01-17T00:00:00,65849,5958,6584,52663,29979819,12455164,799278,,11655886,5669009
3202,2022-01-18T00:00:00,36267,2055,2180,31206,30016086,12456863,799142,,11657721,5700019
3203,2022-01-19T00:00:00,101468,5633,6760,86014,30117554,12462096,797997,,11664099,5785806
3204,2022-01-20T00:00:00,103743,6359,7045,85799,30221297,12468071,797303,,11670768,5871382
3205,2022-01-21T00:00:00,102242,6271,8096,82560,30323539,12473938,795464,,11678474,5953714
3206,2022-01-22T00:00:00,102709,8750,12109,78172,30426248,12482299,792098,,11690201,6031658
3207,2022-01-23T00:00:00,76796,7340,14018,54838,30503044,12489295,785412,,11703883,6086274
3208,2022-01-24T00:00:00,42319,3205,7956,30765,30545363,12492136,780643,,11711493,6116832
3209,2022-01-25T00:00:00,62684,3789,8407,48163,30608047,12495542,776010,,11719532,6164774
3210,2022-01-26T00:00:00,77997,4958,13195,55730,30686044,12500123,767768,,11732355,6220262
3211,2022-01-27T00:00:00,78159,4916,13275,56081,30764203,12504667,759399,,11745268,6276106
3212,2022-01-28T00:00:00,77395,4711,13710,53925,30841598,12509020,750387,,11758633,6329812
3213,2022-01-29T00:00:00,84936,5551,17753,58162,30926534,12514207,738178,,11776029,6387729
3214,2022-01-30T00:00:00,66592,5059,20657,40177,30993126,12518925,722566,,11796359,6427682
3215,2022-01-31T00:00:00,34812,2191,9918,22363,31027938,12520796,714830,,11805966,6449855
3216,2022-02-01T00:00:00,51442,3298,9688,36563,31079380,12523741,708430,,11815311,6486193
3217,2022-02-02T00:00:00,57835,3886,12440,38707,31137215,12527295,699861,,11827434,6524699
3218,2022-02-03T00:00:00,52667,3632,11540,34330,31189882,12530548,691941,,11838607,6558777
3219,2022-02-04T00:00:00,43207,2981,10597,27314,31233089,12533217,684315,,11848902,6585896
3220,2022-02-05T00:00:00,58826,3774,14507,37592,31291915,12536659,673570,,11863089,6623275
3221,2022-02-06T00:00:00,49947,3662,16136,29608,31341862,12539998,661091,,11878907,6652659
3222,2022-02-07T00:00:00,23284,1703,7831,13454,31365146,12541375,654950,,11886425,6665889
3223,2022-02-08T00:00:00,33508,2384,7283,21998,31398654,12543429,650044,,11893385,6687654
3224,2022-02-09T00:00:00,38993,2820,8945,24438,31437647,12545890,643913,,11901977,6711840
3225,2022-02-10T00:00:00,37623,2788,8859,22577,31475270,12548341,637838,,11910503,6734186
3226,2022-02-11T00:00:00,39545,2739,10330,23028,31514815,12550731,630237,,11920494,6756974
3227,2022-02-12T00:00:00,42146,2976,11481,25355,31556961,12553373,621721,,11931652,6782105
3228,2022-02-13T00:00:00,36404,2823,13168,19958,31593365,12555909,611373,,11944536,6801865
3229,2022-02-14T00:00:00,17013,1184,6134,9485,31610378,12556817,606415,,11950402,6811149
3230,2022-02-15T00:00:00,19438,1402,4779,11900,31629816,12557895,603028,,11954867,6822822
3231,2022-02-16T00:00:00,26117,1786,7762,14974,31655933,12559384,597048,,11962336,6837595
3232,2022-02-17T00:00:00,26833,1696,7552,15000,31682766,12560725,591183,,11969542,6852340
3233,2022-02-18T00:00:00,24025,1365,6641,13705,31706791,12561772,585895,,11975877,6865836
3234,2022-02-19T00:00:00,37926,1924,8367,26082,31744717,12563362,579447,,11983915,6891675
3235,2022-02-20T00:00:00,32644,1508,7985,22824,31777361,12564569,572962,,11991607,6914294
3236,2022-02-21T00:00:00,17521,917,3682,12767,31794882,12565189,570188,,11995001,6926848
3237,2022-02-22T00:00:00,9155,446,1567,6967,31804037,12565345,569062,,11996283,6933604
3238,2022-02-23T00:00:00,25411,1343,4825,17311,31829448,12566378,565573,,12000805,6950679
3239,2022-02-24T00:00:00,24629,1416,5250,15493,31854077,12567471,561734,,12005737,6965929
3240,2022-02-25T00:00:00,23165,1407,5154,14525,31877242,12568584,557980,,12010604,6980228
3241,2022-02-26T00:00:00,25295,1397,5933,16574,31902537,12569671,553437,,12016234,6996576
3242,2022-02-27T00:00:00,27001,1375,7388,17719,31929538,12570777,547413,,12023364,7014100
3243,2022-02-28T00:00:00,10136,595,2533,6746,31939674,12571118,545467,,12025651,7020663
3244,2022-03-01T00:00:00,13249,960,3174,8177,31952923,12571772,543243,,12028529,7028622
3245,2022-03-02T00:00:00,15457,1175,3592,9634,31968380,12572684,540819,,12031865,7038077
3246,2022-03-03T00:00:00,14340,1091,3241,8696,31982720,12573463,538661,,12034802,7046542
3247,2022-03-04T00:00:00,14542,1002,3466,8337,31997262,12574143,536193,,12037950,7054625
3248,2022-03-05T00:00:00,18581,1283,5014,11204,32015843,12575116,532451,,12042665,7065605
3249,2022-03-06T00:00:00,16554,1098,5533,9613,32032397,12575932,528010,,12047922,7075010
3250,2022-03-07T00:00:00,5965,473,1859,3513,32038362,12576120,526617,,12049503,7078306
3251,2022-03-08T00:00:00,7402,712,1956,4165,32045764,12576553,525365,,12051188,7082272
3252,2022-03-09T00:00:00,11227,923,2753,6423,32056991,12577200,523529,,12053671,7088493
3253,2022-03-10T00:00:00,12808,1047,3273,6852,32069799,12577970,521296,,12056674,7095132
3254,2022-03-11T00:00:00,12949,929,3426,6882,32082748,12578610,518791,,12059819,7101798
3255,2022-03-12T00:00:00,14737,1057,4213,8315,32097485,12579395,515632,,12063763,7109909
3256,2022-03-13T00:00:00,14797,1095,5014,8352,32112282,12580198,511708,,12068490,7118024
3257,2022-03-14T00:00:00,6352,453,2235,3506,32118634,12580379,509923,,12070456,7121316
3258,2022-03-15T00:00:00,10237,801,2643,5985,32128871,12580889,508069,,12072820,7127086
3259,2022-03-16T00:00:00,13108,946,3680,6967,32141979,12581544,505332,,12076212,7133821
3260,2022-03-17T00:00:00,13242,1059,3981,6770,32155221,12582314,502403,,12079911,7140370
3261,2022-03-18T00:00:00,11945,920,3159,6443,32167166,12582931,500154,,12082777,7146589
3262,2022-03-19T00:00:00,14475,1009,4172,7919,32181641,12583660,496989,,12086671,7154289
3263,2022-03-20T00:00:00,11775,998,3966,6379,32193416,12584386,494016,,12090370,7160460
3264,2022-03-21T00:00:00,5067,418,1590,2814,32198483,12584545,492840,,12091705,7163071
3265,2022-03-22T00:00:00,6755,556,1572,3905,32205238,12584812,491818,,12092994,7166759
3266,2022-03-23T00:00:00,10021,795,2322,5210,32215259,12585291,490288,,12095003,7171728
3267,2022-03-24T00:00:00,9327,730,2384,4624,32224586,12585757,488625,,12097132,7176148
3268,2022-03-25T00:00:00,9272,787,2170,4771,32233858,12586281,487234,,12099047,7180707
3269,2022-03-26T00:00:00,10977,943,2851,5521,32244835,12586947,485324,,12101623,7186009
3270,2022-03-27T00:00:00,10250,914,3547,5307,32255085,12587601,482687,,12104914,7191105
3271,2022-03-28T00:00:00,3600,324,1113,1994,32258685,12587684,481895,,12105789,7192904
3272,2022-03-29T00:00:00,5378,507,1228,2695,32264063,12587906,481168,,12106738,7195377
3273,2022-03-30T00:00:00,7880,751,1850,4129,32271943,12588377,480064,,12108313,7199280
3274,2022-03-31T00:00:00,8693,697,1941,4422,32280636,12588784,478814,,12109970,7203479
3275,2022-04-01T00:00:00,9354,807,1933,4903,32289990,12589300,477679,,12111621,7208144
3276,2022-04-02T00:00:00,10476,891,2225,5585,32300466,12589905,476333,,12113572,7213513
3277,2022-04-03T00:00:00,9233,885,2574,5069,32309699,12590533,474638,,12115895,7218380
3278,2022-04-04T00:00:00,4226,389,1010,2414,32313925,12590660,474014,,12116646,7220590
3279,2022-04-05T00:00:00,6117,605,1054,3061,32320042,12590924,473559,,12117365,7223375
3280,2022-04-06T00:00:00,8424,723,1503,4389,32328466,12591356,472774,,12118582,7227537
3281,2022-04-07T00:00:00,10375,737,1694,4843,32338841,12591793,471812,,12119981,7232137
3282,2022-04-08T00:00:00,24043,818,1602,4850,32362884,12592333,471022,,12121311,7236771
3283,2022-04-09T00:00:00,30534,976,1985,5907,32393418,12593011,470004,,12123007,7242455
3284,2022-04-10T00:00:00,24901,980,2406,5343,32418319,12593732,468572,,12125160,7247596
3285,2022-04-11T00:00:00,12597,388,882,2436,32430916,12593869,468074,,12125795,7249830
3286,2022-04-12T00:00:00,28190,698,1037,3547,32459106,12594263,467728,,12126535,7253144
3287,2022-04-13T00:00:00,37833,858,1574,4945,32496939,12594822,467008,,12127814,7257859
3288,2022-04-14T00:00:00,37943,766,1632,4919,32534882,12595274,466139,,12129135,7262524
3289,2022-04-15T00:00:00,43448,1241,2112,6731,32578330,12596217,465264,,12130953,7269018
3290,2022-04-16T00:00:00,8125,361,657,1749,32586455,12596318,464966,,12131352,7270551
3291,2022-04-17T00:00:00,21065,874,1937,4325,32607520,12596906,463896,,12133010,7274651
3292,2022-04-18T00:00:00,5476,307,470,1295,32612996,12596926,463728,,12133198,7275705
3293,2022-04-19T00:00:00,22701,621,788,3109,32635697,12597261,463552,,12133709,7278592
3294,2022-04-20T00:00:00,40387,1067,1420,4627,32676084,12598002,463196,,12134806,7282955
3295,2022-04-21T00:00:00,38808,952,1618,4690,32714892,12598658,462521,,12136137,7287411
3296,2022-04-22T00:00:00,35676,1024,1452,4277,32750568,12599410,462086,,12137324,7291470
3297,2022-04-23T00:00:00,34702,1009,1756,4721,32785270,12600134,461336,,12138798,7295952
3298,2022-04-24T00:00:00,20870,1024,1918,3782,32806140,12600908,460439,,12140469,7299540
3299,2022-04-25T00:00:00,8312,455,693,1710,32814452,12601094,460200,,12140894,7301034
3300,2022-04-26T00:00:00,24675,739,970,3157,32839127,12601542,459964,,12141578,7303954
3301,2022-04-27T00:00:00,33644,960,1388,3941,32872771,12602224,459528,,12142696,7307677
3302,2022-04-28T00:00:00,32888,939,1433,3941,32905659,12602890,459025,,12143865,7311395
3303,2022-04-29T00:00:00,32108,1098,1399,3920,32937767,12603690,458717,,12144973,7315086
3304,2022-04-30T00:00:00,30332,929,1556,4029,32968099,12604321,458083,,12146238,7318879
3305,2022-05-01T00:00:00,16779,773,1588,2972,32984878,12604794,457263,,12147531,7321606
3306,2022-05-02T00:00:00,5948,310,529,1101,32990826,12604806,457039,,12147767,7322479
3307,2022-05-03T00:00:00,20970,591,850,2351,33011796,12605092,456774,,12148318,7324591
3308,2022-05-04T00:00:00,29439,803,1101,3294,33041235,12605583,456471,,12149112,7327634
3309,2022-05-05T00:00:00,29132,878,1176,3132,33070367,12606147,456163,,12149984,7330520
3310,2022-05-06T00:00:00,29141,1151,1299,2996,33099508,12607009,456010,,12150999,7333289
3311,2022-05-07T00:00:00,28530,875,1276,3118,33128038,12607593,455604,,12151989,7336183
3312,2022-05-08T00:00:00,16028,896,1318,2329,33144066,12608232,455180,,12153052,7338311
3313,2022-05-09T00:00:00,5912,293,482,946,33149978,12608258,454984,,12153274,7339047
3314,2022-05-10T00:00:00,21258,701,733,2122,33171236,12608640,454945,,12153695,7340908
3315,2022-05-11T00:00:00,28977,842,1095,2660,33200213,12609150,454688,,12154462,7343297
3316,2022-05-12T00:00:00,28272,803,1096,2525,33228485,12609655,454391,,12155264,7345580
3317,2022-05-13T00:00:00,27633,886,1129,2475,33256118,12610230,454143,,12156087,7347798
3318,2022-05-14T00:00:00,25733,816,1108,2619,33281851,12610734,453844,,12156890,7350163
3319,2022-05-15T00:00:00,14868,752,1284,2059,33296719,12611214,453305,,12157909,7352003
3320,2022-05-16T00:00:00,6396,326,536,1053,33303115,12611302,453091,,12158211,7352869
3321,2022-05-17T00:00:00,19628,592,786,1748,33322743,12611578,452890,,12158688,7354368
3322,2022-05-18T00:00:00,26574,877,1110,2280,33349317,12612190,452652,,12159538,7356432
3323,2022-05-19T00:00:00,24468,686,1168,2164,33373785,12612609,452163,,12160446,7358379
3324,2022-05-20T00:00:00,24302,808,1151,2222,33398087,12613146,451816,,12161330,7360381
3325,2022-05-21T00:00:00,22435,697,1176,2355,33420522,12613533,451328,,12162205,7362493
3326,2022-05-22T00:00:00,10591,554,899,1496,33431113,12613826,450978,,12162848,7363772
3327,2022-05-23T00:00:00,4591,242,466,803,33435704,12613808,450752,,12163056,7364366
3328,2022-05-24T00:00:00,2656,125,188,453,33438360,12613676,450687,,12162989,7364607
3329,2022-05-25T00:00:00,19409,663,959,1965,33457769,12614072,450381,,12163691,7366361
3330,2022-05-26T00:00:00,20682,667,959,1920,33478451,12614463,450083,,12164380,7368057
3331,2022-05-27T00:00:00,21810,822,1077,2086,33500261,12614996,449825,,12165171,7369909
3332,2022-05-28T00:00:00,19453,726,1177,2160,33519714,12615450,449371,,12166079,7371854
3333,2022-05-29T00:00:00,12133,763,1290,1730,33531847,12615977,448837,,12167140,7373391
3334,2022-05-30T00:00:00,4592,311,549,758,33536439,12616041,448595,,12167446,7373951
3335,2022-05-31T00:00:00,13590,577,764,1681,33550029,12616316,448402,,12167914,7375392
3336,2022-06-01T00:00:00,16663,707,992,1892,33566692,12616720,448115,,12168605,7377031
3337,2022-06-02T00:00:00,14658,567,876,1690,33581350,12616975,447799,,12169176,7378480
3338,2022-06-03T00:00:00,16139,705,1103,1824,33597489,12617397,447395,,12170002,7380082
3339,2022-06-04T00:00:00,13347,648,1171,1854,33610836,12617787,446867,,12170920,7381734
3340,2022-06-05T00:00:00,7901,592,1118,1443,33618737,12618130,446337,,12171793,7382985
3341,2022-06-06T00:00:00,3303,208,447,643,33622040,12618089,446095,,12171994,7383426
3342,2022-06-07T00:00:00,11263,487,739,1382,33633303,12618276,445838,,12172438,7384564
3343,2022-06-08T00:00:00,14088,673,1022,1609,33647391,12618688,445484,,12173204,7385953
3344,2022-06-09T00:00:00,13422,669,937,1676,33660813,12619068,445211,,12173857,7387397
3345,2022-06-10T00:00:00,13894,689,1085,1703,33674707,12619469,444806,,12174663,7388870
3346,2022-06-11T00:00:00,13022,625,1038,1846,33687729,12619808,444391,,12175417,7390493
3347,2022-06-12T00:00:00,8119,645,1241,1507,33695848,12620194,443791,,12176403,7391793
3348,2022-06-13T00:00:00,3206,287,429,719,33699054,12620213,443644,,12176569,7392302
3349,2022-06-14T00:00:00,10161,520,675,1274,33709215,12620443,443483,,12176960,7393338
3350,2022-06-15T00:00:00,13539,477,840,1628,33722754,12620623,443118,,12177505,7394727
3351,2022-06-16T00:00:00,12579,503,869,1615,33735333,12620818,442746,,12178072,7396094
3352,2022-06-17T00:00:00,11721,485,829,1653,33747054,12621014,442395,,12178619,7397509
3353,2022-06-18T00:00:00,11476,438,881,1867,33758530,12621181,441949,,12179232,7399152
3354,2022-06-19T00:00:00,7022,487,904,1423,33765552,12621413,441531,,12179882,7400358
3355,2022-06-20T00:00:00,2290,148,302,644,33767842,12621337,441371,,12179966,7400832
3356,2022-06-21T00:00:00,9581,365,628,1397,33777423,12621415,441103,,12180312,7401981
3357,2022-06-22T00:00:00,13659,419,742,1712,33791082,12621562,440773,,12180789,7403468
3358,2022-06-23T00:00:00,13739,410,788,1680,33804821,12621704,440392,,12181312,7404934
3359,2022-06-24T00:00:00,15397,446,820,1678,33820218,12621890,440014,,12181876,7406397
3360,2022-06-25T00:00:00,14523,436,863,1725,33834741,12622064,439576,,12182488,7407912
3361,2022-06-26T00:00:00,8182,436,891,1289,33842923,12622238,439114,,12183124,7408984
3362,2022-06-27T00:00:00,3230,176,369,599,33846153,12622164,438917,,12183247,7409375
3363,2022-06-28T00:00:00,9646,380,570,1224,33855799,12622257,438723,,12183534,7410365
3364,2022-06-29T00:00:00,13364,425,739,1642,33869163,12622391,438407,,12183984,7411767
3365,2022-06-30T00:00:00,12273,493,857,1582,33881436,12622599,438041,,12184558,7413115
3366,2022-07-01T00:00:00,13076,556,981,1948,33894512,12622896,437611,,12185285,7414856
3367,2022-07-02T00:00:00,1656,118,130,375,33896168,12622738,437597,,12185141,7414999
3368,2022-07-03T00:00:00,5179,260,497,968,33901347,12622739,437351,,12185388,7415750
3369,2022-07-04T00:00:00,2771,133,280,619,33904118,12622625,437203,,12185422,7416172
3370,2022-07-05T00:00:00,11171,375,608,1581,33915289,12622702,436962,,12185740,7417505
3371,2022-07-06T00:00:00,15989,552,865,2019,33931278,12622956,436643,,12186313,7419279
3372,2022-07-07T00:00:00,15704,530,840,1936,33946982,12623197,436332,,12186865,7420962
3373,2022-07-08T00:00:00,17929,563,879,2253,33964911,12623454,436015,,12187439,7422965
3374,2022-07-09T00:00:00,14180,458,608,1854,33979091,12623632,435864,,12187768,7424580
3375,2022-07-10T00:00:00,8772,476,760,1514,33987863,12623856,435579,,12188277,7425885
3376,2022-07-11T00:00:00,4106,201,335,873,33991969,12623790,435442,,12188348,7426536
3377,2022-07-12T00:00:00,12149,416,535,1665,34004118,12623907,435318,,12188589,7427947
3378,2022-07-13T00:00:00,16753,570,778,2148,34020871,12624179,435104,,12189075,7429850
3379,2022-07-14T00:00:00,16904,487,687,2032,34037775,12624361,434893,,12189468,7431643
3380,2022-07-15T00:00:00,28928,599,835,2180,34066703,12624659,434656,,12190003,7433581
3381,2022-07-16T00:00:00,30347,591,781,2350,34097050,12624936,434458,,12190478,7435678
3382,2022-07-17T00:00:00,22972,542,635,1909,34120022,12625239,434362,,12190877,7437391
3383,2022-07-18T00:00:00,11409,191,257,858,34131431,12625161,434291,,12190870,7438026
3384,2022-07-19T00:00:00,29012,596,604,2159,34160443,12625481,434280,,12191201,7439953
3385,2022-07-20T00:00:00,37693,844,933,2608,34198136,12626044,434186,,12191858,7442322
3386,2022-07-21T00:00:00,36434,746,827,2825,34234570,12626501,434098,,12192403,7444905
3387,2022-07-22T00:00:00,35862,827,905,2701,34270432,12627038,434013,,12193025,7447368
3388,2022-07-23T00:00:00,35212,826,928,2853,34305644,12627548,433903,,12193645,7449964
3389,2022-07-24T00:00:00,21785,603,814,1794,34327429,12627888,433689,,12194199,7451533
3390,2022-07-25T00:00:00,11953,310,311,1085,34339382,12627912,433683,,12194229,7452386
3391,2022-07-26T00:00:00,26132,620,611,2228,34365514,12628246,433691,,12194555,7454369
3392,2022-07-27T00:00:00,32522,813,861,2663,34398036,12628800,433641,,12195159,7456820
3393,2022-07-28T00:00:00,31574,727,889,2606,34429610,12629227,433475,,12195752,7459172
3394,2022-07-29T00:00:00,30049,1792,886,2659,34459659,12630725,434377,,12196348,7461579
3395,2022-07-30T00:00:00,25880,2527,756,2438,34485539,12632971,436146,,12196825,7463784
3396,2022-07-31T00:00:00,14358,1072,545,1589,34499897,12633771,436669,,12197102,7465143
3397,2022-08-01T00:00:00,5933,339,227,687,34505830,12633849,436779,,12197070,7465606
3398,2022-08-02T00:00:00,4521,310,148,616,34510351,12633888,436937,,12196951,7465999
3399,2022-08-03T00:00:00,22998,2653,750,2260,34533349,12636264,438836,,12197428,7468023
3400,2022-08-04T00:00:00,22292,2488,689,2150,34555641,12638423,440629,,12197794,7469908
3401,2022-08-05T00:00:00,21834,2760,754,2080,34577475,12640900,442627,,12198273,7471758
3402,2022-08-06T00:00:00,19691,2879,660,2006,34597166,12643465,444840,,12198625,7473503
3403,2022-08-07T00:00:00,12731,2235,625,1437,34609897,12645424,446444,,12198980,7474721
3404,2022-08-08T00:00:00,4775,570,189,607,34614672,12645702,446818,,12198884,7475089
3405,2022-08-09T00:00:00,14054,1472,565,1616,34628726,12646884,447719,,12199165,7476463
3406,2022-08-10T00:00:00,19162,2364,729,2000,34647888,12648974,449352,,12199622,7478233
3407,2022-08-11T00:00:00,17122,2045,727,1874,34665010,12650742,450668,,12200074,7479873
3408,2022-08-12T00:00:00,17011,2052,743,1847,34682021,12652505,451976,,12200529,7481491
3409,2022-08-13T00:00:00,15993,2234,784,1819,34698014,12654452,453424,,12201028,7483067
3410,2022-08-14T00:00:00,9549,1622,624,1092,34707563,12655783,454418,,12201365,7483922
3411,2022-08-15T00:00:00,3882,387,272,486,34711445,12655913,454530,,12201383,7484198
3412,2022-08-16T00:00:00,10832,1078,519,1364,34722277,12656688,455087,,12201601,7485309
3413,2022-08-17T00:00:00,16148,1841,746,1796,34738425,12658237,456180,,12202057,7486867
3414,2022-08-18T00:00:00,14956,1644,751,1701,34753381,12659555,457069,,12202486,7488295
3415,2022-08-19T00:00:00,15351,1852,756,1564,34768732,12661128,458161,,12202967,7489625
3416,2022-08-20T00:00:00,14308,1643,744,1558,34783040,12662476,459054,,12203422,7490941
3417,2022-08-21T00:00:00,9927,1532,666,1178,34792967,12663740,459916,,12203824,7491900
3418,2022-08-22T00:00:00,4180,481,276,565,34797147,12663915,460118,,12203797,7492204
3419,2022-08-23T00:00:00,11185,1254,562,1518,34808332,12664859,460806,,12204053,7493468
3420,2022-08-24T00:00:00,14790,1810,876,2204,34823122,12666397,461740,,12204657,7495440
3421,2022-08-25T00:00:00,14056,1721,786,2129,34837178,12667828,462668,,12205160,7497322
3422,2022-08-26T00:00:00,13961,1691,826,2100,34851139,12669220,463526,,12205694,7499171
3423,2022-08-27T00:00:00,12447,1490,879,2013,34863586,12670382,464131,,12206251,7500917
3424,2022-08-28T00:00:00,7949,1258,625,1411,34871535,12671378,464762,,12206616,7502107
3425,2022-08-29T00:00:00,3408,504,286,685,34874943,12671599,464975,,12206624,7502556
3426,2022-08-30T00:00:00,9928,1169,656,1861,34884871,12672409,465482,,12206927,7504113
3427,2022-08-31T00:00:00,13538,1631,950,2320,34898409,12673745,466159,,12207586,7506187
3428,2022-09-01T00:00:00,12938,1725,921,2152,34911347,12675174,466958,,12208216,7508093
3429,2022-09-02T00:00:00,15068,1617,1000,4924,34926415,12676513,467567,,12208946,7512788
3430,2022-09-03T00:00:00,14739,1530,930,5522,34941154,12677754,468164,,12209590,7518071
3431,2022-09-04T00:00:00,8694,1015,685,3247,34949848,12678502,468484,,12210018,7521096
3432,2022-09-05T00:00:00,3563,321,230,1389,34953411,12678554,468572,,12209982,7522260
3433,2022-09-06T00:00:00,2487,159,120,1139,34955898,12678456,468608,,12209848,7523189
3434,2022-09-07T00:00:00,10952,1022,596,3495,34966850,12679176,469030,,12210146,7526429
3435,2022-09-08T00:00:00,10900,1029,537,2794,34977750,12679874,469519,,12210355,7528944
3436,2022-09-09T00:00:00,9609,1018,494,2509,34987359,12680602,470038,,12210564,7531216
3437,2022-09-10T00:00:00,10681,1275,559,3170,34998040,12681597,470747,,12210850,7534150
3438,2022-09-11T00:00:00,9442,982,674,3743,35007482,12682329,471049,,12211280,7537682
3439,2022-09-12T00:00:00,3137,296,206,1081,35010619,12682340,471132,,12211208,7538525
3440,2022-09-13T00:00:00,6054,549,294,1141,35016673,12682598,471378,,12211220,7539419
3441,2022-09-14T00:00:00,14503,798,439,1851,35031176,12683075,471733,,12211342,7541002
3442,2022-09-15T00:00:00,15789,785,418,1543,35046965,12683539,472095,,12211444,7542273
3443,2022-09-16T00:00:00,17782,770,452,1700,35064747,12684045,472407,,12211638,7543748
3444,2022-09-17T00:00:00,17650,726,465,1676,35082397,12684462,472664,,12211798,7545166
3445,2022-09-18T00:00:00,11233,773,451,1693,35093630,12684970,472984,,12211986,7546633
3446,2022-09-19T00:00:00,4992,405,287,670,35098622,12685100,473097,,12212003,7547087
3447,2022-09-20T00:00:00,13810,449,339,944,35112432,12685232,473205,,12212027,7547766
3448,2022-09-21T00:00:00,23084,656,421,1501,35135516,12685576,473435,,12212141,7549010
3449,2022-09-22T00:00:00,22954,639,409,1396,35158470,12685903,473659,,12212244,7550142
3450,2022-09-23T00:00:00,22993,731,609,1420,35181463,12686326,473776,,12212550,7551300
3451,2022-09-24T00:00:00,21725,742,696,1506,35203188,12686773,473818,,12212955,7552569
3452,2022-09-25T00:00:00,11341,595,700,1361,35214529,12687084,473707,,12213377,7553691
3453,2022-09-26T00:00:00,4577,193,223,596,35219106,12686984,473671,,12213313,7554041
3454,2022-09-27T00:00:00,37682,496,373,1496,35256788,12687209,473790,,12213419,7555309
3455,2022-09-28T00:00:00,51006,733,676,1905,35307794,12687672,473846,,12213826,7556987
3456,2022-09-29T00:00:00,48063,640,754,1837,35355857,12687986,473724,,12214262,7558544
3457,2022-09-30T00:00:00,47310,675,815,2001,35403167,12688333,473582,,12214751,7560263
3458,2022-10-01T00:00:00,34478,524,639,1553,35437645,12688547,473465,,12215082,7561548
3459,2022-10-02T00:00:00,24273,737,1035,1710,35461918,12688985,473164,,12215821,7563003
3460,2022-10-03T00:00:00,10883,237,235,612,35472801,12688929,473162,,12215767,7563376
3461,2022-10-04T00:00:00,32225,477,465,1164,35505026,12689083,473170,,12215913,7564260
3462,2022-10-05T00:00:00,40468,633,744,1558,35545494,12689391,473052,,12216339,7565550
3463,2022-10-06T00:00:00,38730,610,659,1569,35584224,12689693,473001,,12216692,7566856
3464,2022-10-07T00:00:00,42285,665,861,1742,35626509,12690010,472797,,12217213,7568296
3465,2022-10-08T00:00:00,37437,786,1148,2127,35663946,12690461,472429,,12218032,7570145
3466,2022-10-09T00:00:00,18836,548,730,1555,35682782,12690727,472244,,12218483,7571458
3467,2022-10-10T00:00:00,6879,163,373,570,35689661,12690590,472031,,12218559,7571766
3468,2022-10-11T00:00:00,5023,131,120,320,35694684,12690425,472037,,12218388,7571847
3469,2022-10-12T00:00:00,35141,580,687,1431,35729825,12690669,471928,,12218741,7572986
3470,2022-10-13T00:00:00,36798,648,865,1621,35766623,12690944,471707,,12219237,7574293
3471,2022-10-14T00:00:00,37013,624,759,1537,35803636,12691230,471568,,12219662,7575546
3472,2022-10-15T00:00:00,35495,720,1022,1631,35839131,12691655,471263,,12220392,7576926
3473,2022-10-16T00:00:00,20686,655,1030,1593,35859817,12692036,470882,,12221154,7578285
3474,2022-10-17T00:00:00,7365,207,479,543,35867182,12691953,470608,,12221345,7578584
3475,2022-10-18T00:00:00,36472,455,508,1398,35903654,12692083,470550,,12221533,7579707
3476,2022-10-19T00:00:00,49937,619,734,1978,35953591,12692397,470431,,12221966,7581432
3477,2022-10-20T00:00:00,51325,620,654,2050,36004916,12692699,470394,,12222305,7583214
3478,2022-10-21T00:00:00,52878,700,626,1928,36057794,12693067,470462,,12222605,7584870
3479,2022-10-22T00:00:00,50910,753,910,2315,36108704,12693484,470300,,12223184,7586905
3480,2022-10-23T00:00:00,30668,568,786,2126,36139372,12693730,470075,,12223655,7588763
3481,2022-10-24T00:00:00,14138,232,272,976,36153510,12693655,470030,,12223625,7589477
3482,2022-10-25T00:00:00,41392,472,489,1819,36194902,12693771,470010,,12223761,7590994
3483,2022-10-26T00:00:00,51684,614,665,2118,36246586,12694046,469955,,12224091,7592829
3484,2022-10-27T00:00:00,50159,606,772,2162,36296745,12694323,469781,,12224542,7594717
3485,2022-10-28T00:00:00,49830,586,679,2094,36346575,12694543,469683,,12224860,7596498
3486,2022-10-29T00:00:00,50657,736,783,2226,36397232,12694923,469632,,12225291,7598417
3487,2022-10-30T00:00:00,28427,658,932,2039,36425659,12695291,469354,,12225937,7600208
3488,2022-10-31T00:00:00,12454,200,235,778,36438113,12695202,469315,,12225887,7600744
3489,2022-11-01T00:00:00,33129,339,202,1223,36471242,12695192,469446,,12225746,7601674
3490,2022-11-02T00:00:00,44322,571,626,1910,36515564,12695422,469387,,12226035,7603277
3491,2022-11-03T00:00:00,44231,541,608,1861,36559795,12695626,469315,,12226311,7604847
3492,2022-11-04T00:00:00,44676,648,532,2030,36604471,12695963,469424,,12226539,7606618
3493,2022-11-05T00:00:00,45242,646,760,2369,36649713,12696300,469306,,12226994,7608715
3494,2022-11-06T00:00:00,26042,559,776,2100,36675755,12696511,469086,,12227425,7610513
3495,2022-11-07T00:00:00,10725,243,236,878,36686480,12696458,469090,,12227368,7611146
3496,2022-11-08T00:00:00,33519,488,399,1587,36719999,12696650,469176,,12227474,7612484
3497,2022-11-09T00:00:00,40573,606,574,1970,36760572,12696928,469206,,12227722,7614175
3498,2022-11-10T00:00:00,39229,620,559,1931,36799801,12697222,469261,,12227961,7615827
3499,2022-11-11T00:00:00,43381,641,647,2211,36843182,12697536,469253,,12228283,7617757
3500,2022-11-12T00:00:00,36883,638,597,2191,36880065,12697847,469286,,12228561,7619663
3501,2022-11-13T00:00:00,24294,560,776,2281,36904359,12698103,469064,,12229039,7621683
3502,2022-11-14T00:00:00,10981,231,205,1027,36915340,12698034,469089,,12228945,7622448
3503,2022-11-15T00:00:00,33675,488,388,1697,36949015,12698149,469183,,12228966,7623830
3504,2022-11-16T00:00:00,43560,800,589,2371,36992575,12698643,469388,,12229255,7625944
3505,2022-11-17T00:00:00,38381,678,651,2248,37030956,12698976,469411,,12229565,7627898
3506,2022-11-18T00:00:00,40665,722,535,2339,37071621,12699344,469594,,12229750,7629932
3507,2022-11-19T00:00:00,39702,1009,1038,3065,37111323,12699999,469558,,12230441,7632686
3508,2022-11-20T00:00:00,22453,659,720,2446,37133776,12700371,469493,,12230878,7634895
3509,2022-11-21T00:00:00,8933,198,195,967,37142709,12700297,469491,,12230806,7635648
3510,2022-11-22T00:00:00,26470,486,377,1519,37169179,12700414,469595,,12230819,7636845
3511,2022-11-23T00:00:00,32120,686,669,2075,37201299,12700757,469609,,12231148,7638630
3512,2022-11-24T00:00:00,31961,664,757,2091,37233260,12701099,469513,,12231586,7640453
3513,2022-11-25T00:00:00,30776,762,829,1963,37264036,12701540,469440,,12232100,7642145
3514,2022-11-26T00:00:00,30324,905,1198,2701,37294360,12702095,469138,,12232957,7644547
3515,2022-11-27T00:00:00,18701,608,948,2090,37313061,12702384,468792,,12233592,7646368
3516,2022-11-28T00:00:00,7556,192,283,787,37320617,12702265,468693,,12233572,7646884
3517,2022-11-29T00:00:00,21056,420,455,1296,37341673,12702343,468654,,12233689,7647892
3518,2022-11-30T00:00:00,27920,642,653,1844,37369593,12702655,468641,,12234014,7649450
3519,2022-12-01T00:00:00,24850,605,690,1700,37394443,12702923,468552,,12234371,7650857
3520,2022-12-02T00:00:00,25078,522,632,1778,37419521,12703102,468435,,12234667,7652342
3521,2022-12-03T00:00:00,25592,591,783,1950,37445113,12703360,468233,,12235127,7654019
3522,2022-12-04T00:00:00,15268,494,610,1709,37460381,12703510,468111,,12235399,7655427
3523,2022-12-05T00:00:00,6883,167,158,746,37467264,12703374,468114,,12235260,7655918
3524,2022-12-06T00:00:00,20377,421,354,1383,37487641,12703413,468175,,12235238,7656979
3525,2022-12-07T00:00:00,24823,554,617,1681,37512464,12703638,468104,,12235534,7658380
3526,2022-12-08T00:00:00,23184,565,524,1771,37535648,12703872,468143,,12235729,7659861
3527,2022-12-09T00:00:00,23353,639,578,1633,37559001,12704167,468199,,12235968,7661209
3528,2022-12-10T00:00:00,22606,511,608,1633,37581607,12704348,468099,,12236249,7662555
3529,2022-12-11T00:00:00,14218,547,787,1570,37595825,12704616,467856,,12236760,7663889
3530,2022-12-12T00:00:00,5516,149,157,595,37601341,12704463,467843,,12236620,7664237
3531,2022-12-13T00:00:00,17836,380,377,1130,37619177,12704507,467844,,12236663,7665081
3532,2022-12-14T00:00:00,21353,512,553,1459,37640530,12704711,467797,,12236914,7666286
3533,2022-12-15T00:00:00,22006,536,613,1581,37662536,12704891,467718,,12237173,7667561
3534,2022-12-16T00:00:00,16312,384,454,1031,37678848,12704943,467645,,12237298,7668312
3535,2022-12-17T00:00:00,18736,559,517,1285,37697584,12705164,467685,,12237479,7669300
3536,2022-12-18T00:00:00,12652,530,797,1308,37710236,12705402,467417,,12237985,7670347
3537,2022-12-19T00:00:00,4594,131,117,452,37714830,12705188,467427,,12237761,7670505
3538,2022-12-20T00:00:00,16238,498,455,1114,37731068,12705357,467462,,12237895,7671347
3539,2022-12-21T00:00:00,18505,543,558,1307,37749573,12705585,467443,,12238142,7672380
3540,2022-12-22T00:00:00,18647,572,592,1751,37768220,12705846,467423,,12238423,7673860
3541,2022-12-23T00:00:00,15679,577,609,1724,37783899,12706054,467386,,12238668,7675278
3542,2022-12-24T00:00:00,5359,228,177,679,37789258,12705954,467436,,12238518,7675663
3543,2022-12-25T00:00:00,2455,153,157,480,37791713,12705788,467422,,12238366,7675869
3544,2022-12-26T00:00:00,263,12,8,48,37791976,12705483,467421,,12238062,7675651
3545,2022-12-27T00:00:00,2109,98,39,308,37794085,12705283,467475,,12237808,7675715
3546,2022-12-28T00:00:00,8342,339,176,980,37802427,12705294,467633,,12237661,7676412
3547,2022-12-29T00:00:00,13185,584,531,1601,37815612,12705526,467681,,12237845,7677710
3548,2022-12-30T00:00:00,15848,665,664,1883,37831460,12705869,467679,,12238190,7679308
3549,2022-12-31T00:00:00,11255,460,395,1357,37842715,12705958,467740,,12238218,7680347
3550,2023-01-01T00:00:00,3916,201,219,564,37846631,12705828,467720,,12238108,7680621
3551,2023-01-02T00:00:00,654,37,13,98,37847285,12705557,467743,,12237814,7680454
3552,2023-01-03T00:00:00,8208,296,154,904,37855493,12705544,467879,,12237665,7681098
3553,2023-01-04T00:00:00,14747,579,551,1548,37870240,12705816,467900,,12237916,7682378
3554,2023-01-05T00:00:00,16149,648,542,1802,37886389,12706139,467997,,12238142,7683898
3555,2023-01-06T00:00:00,18869,717,621,2049,37905258,12706538,468090,,12238448,7685671
3556,2023-01-07T00:00:00,18553,706,645,2064,37923811,12706943,468146,,12238797,7687472
3557,2023-01-08T00:00:00,11632,579,609,1639,37935443,12707250,468112,,12239138,7688875
3558,2023-01-09T00:00:00,5310,217,197,665,37940753,12707142,468129,,12239013,7689265
3559,2023-01-10T00:00:00,12178,414,319,789,37952931,12707231,468222,,12239009,7689771
3560,2023-01-11T00:00:00,15581,461,375,1104,37968512,12707347,468302,,12239045,7690585
3561,2023-01-12T00:00:00,14108,445,410,979,37982620,12707463,468336,,12239127,7691287
3562,2023-01-13T00:00:00,14214,421,351,1045,37996834,12707604,468403,,12239201,7692088
3563,2023-01-14T00:00:00,13423,473,454,1082,38010257,12707748,468416,,12239332,7692885
3564,2023-01-15T00:00:00,9058,459,509,1058,38019315,12707903,468365,,12239538,7693688
3565,2023-01-16T00:00:00,3756,146,134,480,38023071,12707752,468377,,12239375,7693908
3566,2023-01-17T00:00:00,8869,265,183,658,38031940,12707661,468455,,12239206,7694265
3567,2023-01-18T00:00:00,10296,351,277,768,38042236,12707692,468525,,12239167,7694750
3568,2023-01-19T00:00:00,10608,313,321,764,38052844,12707692,468512,,12239180,7695251
3569,2023-01-20T00:00:00,9868,330,281,720,38062712,12707717,468559,,12239158,7695704
3570,2023-01-21T00:00:00,11338,354,408,913,38074050,12707747,468504,,12239243,7696344
3571,2023-01-22T00:00:00,7588,342,409,826,38081638,12707804,468432,,12239372,7696921
3572,2023-01-23T00:00:00,3388,144,133,291,38085026,12707688,468442,,12239246,7696983
3573,2023-01-24T00:00:00,8317,231,172,559,38093343,12707578,468498,,12239080,7697246
3574,2023-01-25T00:00:00,10334,347,302,668,38103677,12707635,468539,,12239096,7697669
3575,2023-01-26T00:00:00,6749,239,210,471,38110426,12707560,468564,,12238996,7697878
3576,2023-01-27T00:00:00,6938,242,200,500,38117364,12707471,468603,,12238868,7698097
3577,2023-01-28T00:00:00,9388,315,341,703,38126752,12707476,468571,,12238905,7698537
3578,2023-01-29T00:00:00,5999,236,346,703,38132751,12707407,468456,,12238951,7698973
3579,2023-01-30T00:00:00,1910,88,86,215,38134661,12707188,468456,,12238732,7698921
3580,2023-01-31T00:00:00,5906,158,158,416,38140567,12707014,468451,,12238563,7699046
3581,2023-02-01T00:00:00,7326,251,255,498,38147893,12706990,468444,,12238546,7699312
3582,2023-02-02T00:00:00,6507,298,245,507,38154400,12706995,468493,,12238502,7699582
3583,2023-02-03T00:00:00,6579,200,201,467,38160979,12706904,468487,,12238417,7699797
3584,2023-02-04T00:00:00,6758,234,313,553,38167737,12706850,468401,,12238449,7700107
3585,2023-02-05T00:00:00,4185,200,291,487,38171922,12706749,468305,,12238444,7700344
3586,2023-02-06T00:00:00,1838,90,98,212,38173760,12706525,468294,,12238231,7700279
3587,2023-02-07T00:00:00,4981,160,183,389,38178741,12706351,468267,,12238084,7700391
3588,2023-02-08T00:00:00,5788,216,209,432,38184529,12706258,468268,,12237990,7700557
3589,2023-02-09T00:00:00,6145,213,246,442,38190674,12706167,468234,,12237933,7700742
3590,2023-02-10T00:00:00,5127,163,213,385,38195801,12706073,468179,,12237894,7700909
3591,2023-02-11T00:00:00,6077,184,265,463,38201878,12705951,468093,,12237858,7701098
3592,2023-02-12T00:00:00,4095,223,344,410,38205973,12705900,467968,,12237932,7701266
3593,2023-02-13T00:00:00,1486,57,87,146,38207459,12705684,467936,,12237748,7701182
3594,2023-02-14T00:00:00,3976,136,184,313,38211435,12705509,467886,,12237623,7701219
3595,2023-02-15T00:00:00,4574,123,195,287,38216009,12705345,467811,,12237534,7701263
3596,2023-02-16T00:00:00,4935,176,289,402,38220944,12705211,467693,,12237518,7701399
3597,2023-02-17T00:00:00,5011,183,216,347,38225955,12705119,467656,,12237463,7701515
3598,2023-02-18T00:00:00,5139,234,295,487,38231094,12705067,467593,,12237474,7701758
3599,2023-02-19T00:00:00,3360,132,244,376,38234454,12704916,467476,,12237440,7701898
3600,2023-02-20T00:00:00,1430,63,56,159,38235884,12704705,467480,,12237225,7701824
3601,2023-02-21T00:00:00,924,30,17,108,38236808,12704465,467487,,12236978,7701697
3602,2023-02-22T00:00:00,4155,136,216,371,38240963,12704308,467400,,12236908,7701830
3603,2023-02-23T00:00:00,4308,167,233,395,38245271,12704179,467327,,12236852,7701974
3604,2023-02-24T00:00:00,3043,136,233,275,38248314,12704029,467225,,12236804,7701993
3605,2023-02-25T00:00:00,5040,215,544,386,38253354,12703964,466894,,12237070,7702144
3606,2023-02-26T00:00:00,3489,148,683,388,38256843,12703817,466355,,12237462,7702286
3607,2023-02-27T00:00:00,1080,37,56,97,38257923,12703590,466330,,12237260,7702165
3608,2023-02-28T00:00:00,2747,101,165,237,38260670,12703382,466264,,12237118,7702127
3609,2023-03-01T00:00:00,3878,138,430,346,38264548,12703188,465965,,12237223,7702179
3610,2023-03-02T00:00:00,4617,160,497,331,38269165,12703005,465617,,12237388,7702228
3611,2023-03-03T00:00:00,4393,161,360,341,38273558,12702863,465415,,12237448,7702302
3612,2023-03-04T00:00:00,4989,208,624,355,38278547,12702761,464996,,12237765,7702391
3613,2023-03-05T00:00:00,2550,113,451,256,38281097,12702548,464656,,12237892,7702365
3614,2023-03-06T00:00:00,1166,49,41,114,38282263,12702309,464660,,12237649,7702231
3615,2023-03-07T00:00:00,3251,91,178,232,38285514,12702052,464568,,12237484,7702171
3616,2023-03-08T00:00:00,4347,135,413,293,38289861,12701860,464288,,12237572,7702176
3617,2023-03-09T00:00:00,4650,177,457,318,38294511,12701725,464002,,12237723,7702227
3618,2023-03-10T00:00:00,3970,100,139,259,38298481,12701548,463959,,12237589,7702254
3619,2023-03-11T00:00:00,4092,144,178,290,38302573,12701430,463921,,12237509,7702313
3620,2023-03-12T00:00:00,2929,111,238,305,38305502,12701239,463783,,12237456,7702364
3621,2023-03-13T00:00:00,865,29,32,106,38306367,12701003,463774,,12237229,7702239
3622,2023-03-14T00:00:00,3104,99,112,263,38309471,12700800,463761,,12237039,7702244
3623,2023-03-15T00:00:00,4127,136,163,317,38313598,12700653,463731,,12236922,7702313
3624,2023-03-16T00:00:00,4064,178,234,285,38317662,12700477,463666,,12236811,7702309
3625,2023-03-17T00:00:00,4331,172,214,320,38321993,12700324,463620,,12236704,7702343
3626,2023-03-18T00:00:00,4397,145,195,301,38326390,12700162,463569,,12236593,7702375
3627,2023-03-19T00:00:00,2732,130,234,260,38329122,12700036,463461,,12236575,7702408
3628,2023-03-20T00:00:00,781,34,19,74,38329903,12699774,463473,,12236301,7702232
3629,2023-03-21T00:00:00,2925,69,89,206,38332828,12699551,463447,,12236104,7702192
3630,2023-03-22T00:00:00,3922,131,136,251,38336750,12699373,463439,,12235934,7702168
3631,2023-03-23T00:00:00,3853,119,178,234,38340603,12699177,463374,,12235803,7702135
3632,2023-03-24T00:00:00,3733,103,117,240,38344336,12698994,463357,,12235637,7702138
3633,2023-03-25T00:00:00,4330,107,176,258,38348666,12698807,463281,,12235526,7702144
3634,2023-03-26T00:00:00,2519,113,220,203,38351185,12698627,463168,,12235459,7702102
3635,2023-03-27T00:00:00,923,49,32,69,38352108,12698426,463183,,12235243,7701952
3636,2023-03-28T00:00:00,3124,88,82,207,38355232,12698201,463180,,12235021,7701897
3637,2023-03-29T00:00:00,4222,127,142,228,38359454,12698028,463159,,12234869,7701869
3638,2023-03-30T00:00:00,3883,108,164,219,38363337,12697837,463101,,12234736,7701819
3639,2023-03-31T00:00:00,4031,141,116,229,38367368,12697671,463125,,12234546,7701793
3640,2023-04-01T00:00:00,4249,133,152,232,38371617,12697501,463103,,12234398,7701772
3641,2023-04-02T00:00:00,2206,62,129,175,38373823,12697242,463032,,12234210,7701672
3642,2023-04-03T00:00:00,786,24,12,55,38374609,12696986,463040,,12233946,7701483
3643,2023-04-04T00:00:00,3458,77,79,175,38378067,12696780,463036,,12233744,7701405
3644,2023-04-05T00:00:00,4425,100,116,255,38382492,12696560,463015,,12233545,7701389
3645,2023-04-06T00:00:00,3742,113,113,195,38386234,12696384,463011,,12233373,7701335
3646,2023-04-07T00:00:00,4641,103,121,251,38390875,12696180,462989,,12233191,7701326
3647,2023-04-08T00:00:00,848,23,15,56,38391723,12695933,462991,,12232942,7701155
3648,2023-04-09T00:00:00,2463,81,105,166,38394186,12695766,462964,,12232802,7701111
3649,2023-04-10T00:00:00,365,9,6,22,38394551,12695489,462961,,12232528,7700901
3650,2023-04-11T00:00:00,2803,35,31,131,38397354,12695217,462963,,12232254,7700761
3651,2023-04-12T00:00:00,6393,107,97,194,38403747,12695029,462966,,12232063,7700715
3652,2023-04-13T00:00:00,7056,109,133,215,38410803,12694836,462934,,12231902,7700668
3653,2023-04-14T00:00:00,6565,90,106,211,38417368,12694637,462910,,12231727,7700644
3654,2023-04-15T00:00:00,7002,108,152,240,38424370,12694455,462861,,12231594,7700643
3655,2023-04-16T00:00:00,3303,83,146,174,38427673,12694234,462794,,12231440,7700556
3656,2023-04-17T00:00:00,867,13,13,50,38428540,12693987,462790,,12231197,7700393
3657,2023-04-18T00:00:00,4828,100,80,167,38433368,12693781,462806,,12230975,7700297
3658,2023-04-19T00:00:00,6609,119,103,184,38439977,12693585,462820,,12230765,7700207
3659,2023-04-20T00:00:00,6431,105,157,214,38446408,12693412,462765,,12230647,7700184
3660,2023-04-21T00:00:00,5813,88,82,136,38452221,12693209,462767,,12230442,7700072
3661,2023-04-22T00:00:00,6441,96,93,181,38458662,12693019,462767,,12230252,7700014
3662,2023-04-23T00:00:00,3320,118,148,172,38461982,12692876,462736,,12230140,7699958
3663,2023-04-24T00:00:00,966,4,14,61,38462948,12692607,462723,,12229884,7699799
3664,2023-04-25T00:00:00,4846,69,73,190,38467794,12692387,462719,,12229668,7699733
3665,2023-04-26T00:00:00,6644,109,94,213,38474438,12692230,462733,,12229497,7699713
3666,2023-04-27T00:00:00,6941,119,154,215,38481379,12692051,462692,,12229359,7699675
3667,2023-04-28T00:00:00,6703,87,88,191,38488082,12691855,462687,,12229168,7699617
3668,2023-04-29T00:00:00,6589,125,116,205,38494671,12691685,462692,,12228993,7699570
3669,2023-04-30T00:00:00,2664,95,128,148,38497335,12691525,462658,,12228867,7699496
3670,2023-05-01T00:00:00,1038,21,19,34,38498373,12691253,462651,,12228602,7699283
3671,2023-05-02T00:00:00,4387,67,59,110,38502760,12691018,462653,,12228365,7699136
3672,2023-05-03T00:00:00,5681,111,107,181,38508441,12690840,462650,,12228190,7699073
3673,2023-05-04T00:00:00,8154,85,86,141,38516595,12690624,462646,,12227978,7698969
3674,2023-05-05T00:00:00,13136,91,100,172,38529731,12690435,462632,,12227803,7698899
3675,2023-05-06T00:00:00,15745,110,102,164,38545476,12690289,462638,,12227651,7698835
3676,2023-05-07T00:00:00,6116,56,96,110,38551592,12690090,462591,,12227499,7698727
3677,2023-05-08T00:00:00,2182,18,6,38,38553774,12689840,462598,,12227242,7698539
3678,2023-05-09T00:00:00,12653,61,54,130,38566427,12689617,462598,,12227019,7698432
3679,2023-05-10T00:00:00,14863,72,82,161,38581290,12689412,462583,,12226829,7698359
3680,2023-05-11T00:00:00,13438,80,79,164,38594728,12689237,462583,,12226654,7698297
3681,2023-05-12T00:00:00,13602,83,81,181,38608330,12689041,462580,,12226461,7698239
3682,2023-05-13T00:00:00,11508,80,78,149,38619838,12688792,462577,,12226215,7698103
3683,2023-05-14T00:00:00,4212,68,97,103,38624050,12688596,462544,,12226052,7697995
3684,2023-05-15T00:00:00,1059,9,6,40,38625109,12688353,462541,,12225812,7697823
3685,2023-05-16T00:00:00,8994,57,49,99,38634103,12688121,462542,,12225579,7697679
3686,2023-05-17T00:00:00,11199,97,83,146,38645302,12687928,462550,,12225378,7697562
3687,2023-05-18T00:00:00,10953,79,70,154,38656255,12687714,462557,,12225157,7697465
3688,2023-05-19T00:00:00,10568,96,99,161,38666823,12687517,462548,,12224969,7697366
3689,2023-05-20T00:00:00,9469,92,90,176,38676292,12687290,462545,,12224745,7697262
3690,2023-05-21T00:00:00,3107,48,87,96,38679399,12687087,462504,,12224583,7697139
3691,2023-05-22T00:00:00,975,14,12,30,38680374,12686822,462504,,12224318,7696926
3692,2023-05-23T00:00:00,759,8,3,19,38681133,12686565,462505,,12224060,7696723
3693,2023-05-24T00:00:00,8192,57,82,111,38689325,12686331,462479,,12223852,7696575
3694,2023-05-25T00:00:00,9413,76,94,168,38698738,12686106,462455,,12223651,7696481
3695,2023-05-26T00:00:00,8061,70,73,126,38706799,12685913,462449,,12223464,7696378
3696,2023-05-27T00:00:00,8319,111,79,136,38715118,12685732,462478,,12223254,7696269
3697,2023-05-28T00:00:00,2929,56,73,105,38718047,12685530,462456,,12223074,7696154
3698,2023-05-29T00:00:00,980,13,11,31,38719027,12685275,462453,,12222822,7695949
3699,2023-05-30T00:00:00,6121,57,52,115,38725148,12685025,462454,,12222571,7695798
3700,2023-05-31T00:00:00,8213,94,95,123,38733361,12684813,462448,,12222365,7695670
3701,2023-06-01T00:00:00,7484,70,94,127,38740845,12684599,462421,,12222178,7695552
3702,2023-06-02T00:00:00,6407,56,53,125,38747252,12684352,462421,,12221931,7695413
3703,2023-06-03T00:00:00,5547,72,63,127,38752799,12684119,462429,,12221690,7695284
3704,2023-06-04T00:00:00,2074,47,78,79,38754873,12683895,462390,,12221505,7695130
3705,2023-06-05T00:00:00,608,13,9,19,38755481,12683638,462391,,12221247,7694920
3706,2023-06-06T00:00:00,4516,40,41,81,38759997,12683371,462386,,12220985,7694739
3707,2023-06-07T00:00:00,5899,66,70,127,38765896,12683172,462377,,12220795,7694646
3708,2023-06-08T00:00:00,5828,60,72,114,38771724,12682988,462361,,12220627,7694550
3709,2023-06-09T00:00:00,6271,82,86,123,38777995,12682782,462352,,12220430,7694425
3710,2023-06-10T00:00:00,5413,77,96,121,38783408,12682560,462327,,12220233,7694291
3711,2023-06-11T00:00:00,2019,54,62,107,38785427,12682369,462313,,12220056,7694191
3712,2023-06-12T00:00:00,698,12,8,38,38786125,12682131,462312,,12219819,7694016
3713,2023-06-13T00:00:00,4281,56,59,110,38790406,12681903,462306,,12219597,7693889
3714,2023-06-14T00:00:00,5516,74,86,121,38795922,12681690,462292,,12219398,7693769
3715,2023-06-15T00:00:00,5180,78,78,126,38801102,12681466,462287,,12219179,7693637
3716,2023-06-16T00:00:00,5857,72,66,122,38806959,12681251,462288,,12218963,7693514
3717,2023-06-17T00:00:00,4206,63,62,117,38811165,12681026,462287,,12218739,7693390
3718,2023-06-18T00:00:00,1575,41,61,99,38812740,12680786,462263,,12218523,7693254
3719,2023-06-19T00:00:00,377,7,3,16,38813117,12680525,462263,,12218262,7693045
3720,2023-06-20T00:00:00,3288,54,45,94,38816405,12680276,462268,,12218008,7692879
3721,2023-06-21T00:00:00,3771,44,58,97,38820176,12680058,462247,,12217811,7692743
3722,2023-06-22T00:00:00,4034,72,74,124,38824210,12679860,462240,,12217620,7692633
3723,2023-06-23T00:00:00,4567,54,46,96,38828777,12679658,462242,,12217416,7692512
3724,2023-06-24T00:00:00,3770,52,64,75,38832547,12679420,462227,,12217193,7692341
3725,2023-06-25T00:00:00,1556,31,54,98,38834103,12679174,462200,,12216974,7692208
3726,2023-06-26T00:00:00,524,13,10,25,38834627,12678942,462200,,12216742,7692016
3727,2023-06-27T00:00:00,3169,80,47,95,38837796,12678729,462230,,12216499,7691865
3728,2023-06-28T00:00:00,4165,70,62,92,38841961,12678522,462235,,12216287,7691711
3729,2023-06-29T00:00:00,4090,62,73,91,38846051,12678332,462218,,12216114,7691590
3730,2023-06-30T00:00:00,3917,75,61,131,38849968,12678138,462227,,12215911,7691491
3731,2023-07-01T00:00:00,3303,54,90,125,38853271,12677899,462188,,12215711,7691367
3732,2023-07-02T00:00:00,276,9,4,18,38853547,12677631,462190,,12215441,7691151
3733,2023-07-03T00:00:00,389,8,6,27,38853936,12677394,462191,,12215203,7690977
3734,2023-07-04T00:00:00,1270,19,14,50,38855206,12677152,462194,,12214958,7690800
3735,2023-07-05T00:00:00,2456,60,44,73,38857662,12676947,462206,,12214741,7690651
3736,2023-07-06T00:00:00,2594,39,70,92,38860256,12676684,462172,,12214512,7690485
3737,2023-07-07T00:00:00,2870,53,46,76,38863126,12676498,462173,,12214325,7690360
3738,2023-07-08T00:00:00,2496,68,46,94,38865622,12676287,462191,,12214096,7690214
3739,2023-07-09T00:00:00,939,32,47,38,38866561,12676070,462175,,12213895,7690031
3740,2023-07-10T00:00:00,296,5,3,15,38866857,12675792,462173,,12213619,7689804
3741,2023-07-11T00:00:00,1844,34,21,66,38868701,12675570,462180,,12213390,7689657
3742,2023-07-12T00:00:00,2392,52,55,89,38871093,12675377,462176,,12213201,7689530
3743,2023-07-13T00:00:00,2347,56,71,68,38873440,12675158,462155,,12213003,7689365
3744,2023-07-14T00:00:00,2085,66,51,64,38875525,12674965,462167,,12212798,7689208
3745,2023-07-15T00:00:00,1997,52,57,78,38877522,12674761,462159,,12212602,7689068
3746,2023-07-16T00:00:00,841,37,31,44,38878363,12674529,462162,,12212367,7688888
3747,2023-07-17T00:00:00,200,5,1,11,38878563,12674297,462158,,12212139,7688702
3748,2023-07-18T00:00:00,1350,45,47,56,38879913,12674052,462152,,12211900,7688519
3749,2023-07-19T00:00:00,1914,54,57,60,38881827,12673839,462144,,12211695,7688354
3750,2023-07-20T00:00:00,1721,77,58,65,38883548,12673658,462160,,12211498,7688197
3751,2023-07-21T00:00:00,1781,56,40,53,38885329,12673449,462171,,12211278,7688024
3752,2023-07-22T00:00:00,1568,40,63,81,38886897,12673233,462148,,12211085,7687870
3753,2023-07-23T00:00:00,720,29,32,53,38887617,12673020,462142,,12210878,7687709
3754,2023-07-24T00:00:00,239,11,2,15,38887856,12672777,462149,,12210628,7687502
3755,2023-07-25T00:00:00,1122,49,27,52,38888978,12672540,462168,,12210372,7687299
3756,2023-07-26T00:00:00,1397,48,51,44,38890375,12672339,462163,,12210176,7687124
3757,2023-07-27T00:00:00,1325,67,49,55,38891700,12672133,462176,,12209957,7686949
3758,2023-07-28T00:00:00,1501,49,49,63,38893201,12671917,462175,,12209742,7686776
3759,2023-07-29T00:00:00,1360,51,50,74,38894561,12671696,462171,,12209525,7686613
3760,2023-07-30T00:00:00,666,32,19,30,38895227,12671466,462180,,12209286,7686426
3761,2023-07-31T00:00:00,232,6,4,17,38895459,12671235,462177,,12209058,7686240
3762,2023-08-01T00:00:00,1158,46,33,39,38896617,12671002,462189,,12208813,7686027
3763,2023-08-02T00:00:00,1493,75,58,60,38898110,12670788,462202,,12208586,7685849
3764,2023-08-03T00:00:00,1227,61,39,52,38899337,12670567,462223,,12208344,7685658
3765,2023-08-04T00:00:00,1348,45,48,62,38900685,12670335,462217,,12208118,7685477
3766,2023-08-05T00:00:00,1373,51,52,55,38902058,12670105,462212,,12207893,7685294
3767,2023-08-06T00:00:00,601,25,21,26,38902659,12669889,462215,,12207674,7685107
3768,2023-08-07T00:00:00,250,7,4,9,38902909,12669642,462212,,12207430,7684905
3769,2023-08-08T00:00:00,343,9,5,16,38903252,12669401,462212,,12207189,7684702
3770,2023-08-09T00:00:00,1335,47,41,51,38904587,12669165,462217,,12206948,7684509
3771,2023-08-10T00:00:00,1679,96,53,72,38906266,12669019,462256,,12206763,7684371
3772,2023-08-11T00:00:00,1734,59,49,67,38908000,12668821,462262,,12206559,7684221
3773,2023-08-12T00:00:00,1734,65,48,72,38909734,12668652,462278,,12206374,7684096
3774,2023-08-13T00:00:00,819,29,33,33,38910553,12668417,462273,,12206144,7683898
3775,2023-08-14T00:00:00,256,6,3,6,38910809,12668175,462273,,12205902,7683690
3776,2023-08-15T00:00:00,1338,40,29,43,38912147,12667892,462279,,12205613,7683465
3777,2023-08-16T00:00:00,1709,60,51,52,38913856,12667680,462286,,12205394,7683283
3778,2023-08-17T00:00:00,1779,81,69,65,38915635,12667481,462295,,12205186,7683104
3779,2023-08-18T00:00:00,1760,87,61,56,38917395,12667263,462317,,12204946,7682903
3780,2023-08-19T00:00:00,1790,80,54,73,38919185,12667053,462340,,12204713,7682727
3781,2023-08-20T00:00:00,855,56,47,35,38920040,12666873,462343,,12204530,7682560
3782,2023-08-21T00:00:00,239,4,3,9,38920279,12666562,462342,,12204220,7682305
3783,2023-08-22T00:00:00,1295,56,48,52,38921574,12666307,462344,,12203963,7682097
3784,2023-08-23T00:00:00,1601,68,51,55,38923175,12666104,462357,,12203747,7681923
3785,2023-08-24T00:00:00,1654,95,69,75,38924829,12665893,462383,,12203510,7681730
3786,2023-08-25T00:00:00,1528,87,44,63,38926357,12665679,462422,,12203257,7681540
3787,2023-08-26T00:00:00,1730,79,56,72,38928087,12665483,462441,,12203042,7681377
3788,2023-08-27T00:00:00,831,35,47,52,38928918,12665242,462424,,12202818,7681189
3789,2023-08-28T00:00:00,201,5,3,9,38929119,12664993,462421,,12202572,7680978
3790,2023-08-29T00:00:00,972,51,31,48,38930091,12664758,462437,,12202321,7680765
3791,2023-08-30T00:00:00,1448,119,71,76,38931539,12664601,462482,,12202119,7680597
3792,2023-08-31T00:00:00,1533,97,91,92,38933072,12664413,462484,,12201929,7680446
3793,2023-09-01T00:00:00,1557,98,83,114,38934629,12664255,462494,,12201761,7680340
3794,2023-09-02T00:00:00,1340,79,67,69,38935969,12664067,462504,,12201563,7680179
3795,2023-09-03T00:00:00,701,49,41,35,38936670,12663862,462509,,12201353,7679993
3796,2023-09-04T00:00:00,150,3,1,9,38936820,12663605,462505,,12201100,7679783
3797,2023-09-05T00:00:00,142,6,3,8,38936962,12663336,462503,,12200833,7679559
3798,2023-09-06T00:00:00,1065,46,40,59,38938027,12663072,462506,,12200566,7679352
3799,2023-09-07T00:00:00,1304,55,38,77,38939331,12662820,462515,,12200305,7679169
3800,2023-09-08T00:00:00,1118,67,43,49,38940449,12662608,462536,,12200072,7678978
3801,2023-09-09T00:00:00,1282,62,41,73,38941731,12662375,462551,,12199824,7678797
3802,2023-09-10T00:00:00,868,56,40,51,38942599,12662179,462564,,12199615,7678620
3803,2023-09-11T00:00:00,137,5,4,8,38942736,12661936,462564,,12199372,7678407
3804,2023-09-12T00:00:00,967,33,24,41,38943703,12661647,462568,,12199079,7678173
3805,2023-09-13T00:00:00,1405,76,54,70,38945108,12661416,462585,,12198831,7677978
3806,2023-09-14T00:00:00,1244,61,53,55,38946352,12661187,462589,,12198598,7677787
3807,2023-09-15T00:00:00,1211,76,26,71,38947563,12660970,462636,,12198334,7677606
3808,2023-09-16T00:00:00,1181,86,51,62,38948744,12660771,462669,,12198102,7677423
3809,2023-09-17T00:00:00,715,57,31,54,38949459,12660565,462690,,12197875,7677251
3810,2023-09-18T00:00:00,148,5,3,6,38949607,12660310,462689,,12197621,7677042
3811,2023-09-19T00:00:00,920,62,30,54,38950527,12660033,462718,,12197315,7676811
3812,2023-09-20T00:00:00,1033,80,36,52,38951560,12659841,462756,,12197085,7676623
3813,2023-09-21T00:00:00,914,64,31,59,38952474,12659620,462784,,12196836,7676438
3814,2023-09-22T00:00:00,901,58,35,67,38953375,12659375,462803,,12196572,7676241
3815,2023-09-23T00:00:00,1013,71,56,57,38954388,12659158,462813,,12196345,7676056
3816,2023-09-24T00:00:00,648,37,32,41,38955036,12658935,462815,,12196120,7675873
3817,2023-09-25T00:00:00,134,5,4,10,38955170,12658657,462812,,12195845,7675641
3818,2023-09-26T00:00:00,708,48,22,36,38955878,12658414,462837,,12195577,7675419
3819,2023-09-27T00:00:00,924,77,33,52,38956802,12658200,462877,,12195323,7675233
3820,2023-09-28T00:00:00,850,41,54,43,38957652,12657990,462858,,12195132,7675070
3821,2023-09-29T00:00:00,934,54,32,73,38958586,12657734,462875,,12194859,7674873
3822,2023-09-30T00:00:00,1015,58,31,50,38959601,12657485,462899,,12194586,7674646
3823,2023-10-01T00:00:00,483,34,19,19,38960084,12657236,462911,,12194325,7674419
3824,2023-10-02T00:00:00,135,5,2,10,38960219,12656979,462913,,12194066,7674203
3825,2023-10-03T00:00:00,910,32,9,51,38961129,12656696,462928,,12193768,7673993
3826,2023-10-04T00:00:00,2366,41,35,79,38963495,12656426,462929,,12193497,7673797
3827,2023-10-05T00:00:00,3021,54,33,86,38966516,12656178,462948,,12193230,7673626
3828,2023-10-06T00:00:00,4335,94,48,89,38970851,12655966,462989,,12192977,7673453
3829,2023-10-07T00:00:00,4623,92,65,162,38975474,12655800,463011,,12192789,7673383
3830,2023-10-08T00:00:00,775,36,21,45,38976249,12655532,463022,,12192510,7673164
3831,2023-10-09T00:00:00,145,4,2,5,38976394,12655271,463022,,12192249,7672927
3832,2023-10-10T00:00:00,89,4,1,4,38976483,12655020,463025,,12191995,7672704
3833,2023-10-11T00:00:00,8835,103,54,173,38985318,12654845,463074,,12191771,7672636
3834,2023-10-12T00:00:00,12672,132,92,251,38997990,12654651,463110,,12191541,7672606
3835,2023-10-13T00:00:00,13236,160,69,259,39011226,12654490,463197,,12191293,7672589
3836,2023-10-14T00:00:00,16937,174,107,298,39028163,12654389,463260,,12191129,7672644
3837,2023-10-15T00:00:00,9528,142,75,243,39037691,12654209,463323,,12190886,7672600
3838,2023-10-16T00:00:00,4568,53,31,54,39042259,12653942,463341,,12190601,7672378
3839,2023-10-17T00:00:00,24339,197,102,300,39066598,12653840,463433,,12190407,7672413
3840,2023-10-18T00:00:00,32531,292,151,435,39099129,12653832,463568,,12190264,7672587
3841,2023-10-19T00:00:00,36279,303,132,505,39135408,12653836,463733,,12190103,7672832
3842,2023-10-20T00:00:00,43598,340,165,544,39179006,12653866,463904,,12189962,7673107
3843,2023-10-21T00:00:00,46020,405,196,634,39225026,12653952,464110,,12189842,7673461
3844,2023-10-22T00:00:00,23775,262,138,528,39248801,12653888,464232,,12189656,7673702
3845,2023-10-23T00:00:00,9002,85,45,163,39257803,12653712,464271,,12189441,7673635
3846,2023-10-24T00:00:00,40960,297,148,507,39298763,12653722,464417,,12189305,7673899
3847,2023-10-25T00:00:00,46128,431,182,649,39344891,12653853,464657,,12189196,7674293
3848,2023-10-26T00:00:00,48121,435,186,716,39393012,12653949,464903,,12189046,7674724
3849,2023-10-27T00:00:00,53359,464,199,770,39446371,12654119,465165,,12188954,7675232
3850,2023-10-28T00:00:00,54875,497,242,855,39501246,12654335,465417,,12188918,7675832
3851,2023-10-29T00:00:00,23988,301,157,591,39525234,12654369,465553,,12188816,7676196
3852,2023-10-30T00:00:00,11604,132,53,267,39536838,12654232,465628,,12188604,7676227
3853,2023-10-31T00:00:00,56887,435,195,691,39593725,12654348,465862,,12188486,7676644
3854,2023-11-01T00:00:00,56856,499,197,675,39650581,12654526,466161,,12188365,7677041
3855,2023-11-02T00:00:00,62942,594,245,1075,39713523,12654821,466507,,12188314,7677856
3856,2023-11-03T00:00:00,65236,567,263,1249,39778759,12655070,466803,,12188267,7678833
3857,2023-11-04T00:00:00,63081,709,293,1232,39841840,12655444,467214,,12188230,7679778
3858,2023-11-05T00:00:00,34098,496,228,1128,39875938,12655595,467476,,12188119,7680627
3859,2023-11-06T00:00:00,14327,174,56,401,39890265,12655451,467591,,12187860,7680744
3860,2023-11-07T00:00:00,50029,545,218,877,39940294,12655637,467911,,12187726,7681306
3861,2023-11-08T00:00:00,55305,677,286,1122,39995599,12656031,468298,,12187733,7682187
3862,2023-11-09T00:00:00,55725,694,257,1298,40051324,12656449,468733,,12187716,7683250
3863,2023-11-10T00:00:00,53930,804,276,1166,40105254,12656948,469253,,12187695,7684156
3864,2023-11-11T00:00:00,50108,659,252,1270,40155362,12657241,469654,,12187587,7685111
3865,2023-11-12T00:00:00,24883,454,221,1040,40180245,12657410,469886,,12187524,7685902
3866,2023-11-13T00:00:00,11207,195,51,385,40191452,12657318,470028,,12187290,7686030
3867,2023-11-14T00:00:00,40068,487,200,886,40231520,12657503,470312,,12187191,7686659
3868,2023-11-15T00:00:00,45183,590,227,1107,40276703,12657731,470674,,12187057,7687452
3869,2023-11-16T00:00:00,43545,604,278,1161,40320248,12658007,470997,,12187010,7688319
3870,2023-11-17T00:00:00,41693,625,273,1097,40361941,12658296,471344,,12186952,7689126
3871,2023-11-18T00:00:00,39947,671,255,1313,40401888,12658623,471756,,12186867,7690146
3872,2023-11-19T00:00:00,22500,491,204,1110,40424388,12658834,472040,,12186794,7691015
3873,2023-11-20T00:00:00,9111,150,73,338,40433499,12658688,472112,,12186576,7691106
3874,2023-11-21T00:00:00,32630,465,196,830,40466129,12658846,472377,,12186469,7691684
3875,2023-11-22T00:00:00,35637,668,217,1006,40501766,12659203,472824,,12186379,7692413
3876,2023-11-23T00:00:00,35011,526,254,933,40536777,12659426,473087,,12186339,7693081
3877,2023-11-24T00:00:00,32915,516,204,924,40569692,12659662,473389,,12186273,7693778
3878,2023-11-25T00:00:00,31519,514,247,1110,40601211,12659865,473655,,12186210,7694609
3879,2023-11-26T00:00:00,16843,407,183,972,40618054,12660006,473876,,12186130,7695356
3880,2023-11-27T00:00:00,7043,124,46,332,40625097,12659821,473954,,12185867,7695422
3881,2023-11-28T00:00:00,25138,369,132,636,40650235,12659865,474188,,12185677,7695778
3882,2023-11-29T00:00:00,29817,489,198,949,40680052,12660009,474470,,12185539,7696441
3883,2023-11-30T00:00:00,28615,475,195,899,40708667,12660179,474743,,12185436,7697083
3884,2023-12-01T00:00:00,28636,445,195,884,40737303,12660294,474988,,12185306,7697681
3885,2023-12-02T00:00:00,25726,443,206,897,40763029,12660421,475222,,12185199,7698301
3886,2023-12-03T00:00:00,13579,330,171,739,40776608,12660461,475379,,12185082,7698781
3887,2023-12-04T00:00:00,6073,130,54,290,40782681,12660261,475451,,12184810,7698788
3888,2023-12-05T00:00:00,20457,294,130,660,40803138,12660224,475611,,12184613,7699165
3889,2023-12-06T00:00:00,25472,396,182,797,40828610,12660304,475818,,12184486,7699682
3890,2023-12-07T00:00:00,24456,396,204,810,40853066,12660425,476009,,12184416,7700243
3891,2023-12-08T00:00:00,22858,432,187,779,40875924,12660518,476248,,12184270,7700726
3892,2023-12-09T00:00:00,23322,411,237,822,40899246,12660606,476417,,12184189,7701272
3893,2023-12-10T00:00:00,13662,365,187,866,40912908,12660641,476589,,12184052,7701850
3894,2023-12-11T00:00:00,6611,117,51,340,40919519,12660470,476648,,12183822,7701949
3895,2023-12-12T00:00:00,21006,320,168,666,40940525,12660441,476793,,12183648,7702312
3896,2023-12-13T00:00:00,20308,368,167,745,40960833,12660473,476990,,12183483,7702753
3897,2023-12-14T00:00:00,17976,352,162,766,40978809,12660518,477173,,12183345,7703271
3898,2023-12-15T00:00:00,18018,273,154,618,40996827,12660481,477290,,12183191,7703612
3899,2023-12-16T00:00:00,17808,362,172,693,41014635,12660490,477477,,12183013,7704000
3900,2023-12-17T00:00:00,8992,239,142,614,41023627,12660427,477569,,12182858,7704360
3901,2023-12-18T00:00:00,4251,97,46,244,41027878,12660240,477617,,12182623,7704356
3902,2023-12-19T00:00:00,14814,283,121,588,41042692,12660167,477775,,12182392,7704628
3903,2023-12-20T00:00:00,14808,350,156,553,41057500,12660244,477964,,12182280,7704937
3904,2023-12-21T00:00:00,14846,321,126,633,41072346,12660241,478155,,12182086,7705284
3905,2023-12-22T00:00:00,13361,286,122,551,41085707,12660203,478315,,12181888,7705557
3906,2023-12-23T00:00:00,10627,296,117,442,41096334,12660153,478490,,12181663,7705701
3907,2023-12-24T00:00:00,3945,123,46,244,41100279,12659939,478560,,12181379,7705660
3908,2023-12-25T00:00:00,1342,56,10,89,41101621,12659688,478603,,12181085,7705474
3909,2023-12-26T00:00:00,190,15,7,12,41101811,12659401,478608,,12180793,7705229
3910,2023-12-27T00:00:00,1455,48,10,60,41103266,12659151,478643,,12180508,7705029
3911,2023-12-28T00:00:00,6732,192,74,295,41109998,12659001,478759,,12180242,7705029
3912,2023-12-29T00:00:00,7189,202,91,357,41117187,12658858,478867,,12179991,7705083
3913,2023-12-30T00:00:00,6537,220,78,313,41123724,12658727,479007,,12179720,7705099
3914,2023-12-31T00:00:00,2709,117,34,127,41126433,12658503,479086,,12179417,7704934
3915,2024-01-01T00:00:00,1023,39,10,69,41127456,12658241,479108,,12179133,7704758
3916,2024-01-02T00:00:00,427,18,1,18,41127883,12657963,479120,,12178843,7704522
3917,2024-01-03T00:00:00,5751,185,84,284,41133634,12657801,479217,,12178584,7704508
3918,2024-01-04T00:00:00,7474,263,107,359,41141108,12657717,479369,,12178348,7704570
3919,2024-01-05T00:00:00,8007,267,122,389,41149115,12657635,479512,,12178123,7704654
3920,2024-01-06T00:00:00,8513,238,152,430,41157628,12657519,479594,,12177925,7704779
3921,2024-01-07T00:00:00,3982,168,81,218,41161610,12657388,479677,,12177711,7704736
3922,2024-01-08T00:00:00,1698,65,7,109,41163308,12657122,479729,,12177393,7704568
3923,2024-01-09T00:00:00,5653,176,67,207,41168961,12656968,479834,,12177134,7704484
3924,2024-01-10T00:00:00,4588,140,77,190,41173549,12656734,479889,,12176845,7704356
3925,2024-01-11T00:00:00,5029,153,79,204,41178578,12656532,479959,,12176573,7704253
3926,2024-01-12T00:00:00,5124,116,72,213,41183702,12656361,479999,,12176362,7704212
3927,2024-01-13T00:00:00,6086,183,126,269,41189788,12656247,480048,,12176199,7704227
3928,2024-01-14T00:00:00,2413,87,34,177,41192201,12656029,480095,,12175934,7704142
3929,2024-01-15T00:00:00,1350,41,15,72,41193551,12655784,480118,,12175666,7703961
3930,2024-01-16T00:00:00,3983,187,73,162,41197534,12655674,480229,,12175445,7703865
3931,2024-01-17T00:00:00,3815,152,67,193,41201349,12655521,480310,,12175211,7703790
3932,2024-01-18T00:00:00,3878,118,88,180,41205227,12655339,480337,,12175002,7703714
3933,2024-01-19T00:00:00,4040,140,89,182,41209267,12655149,480383,,12174766,7703618
3934,2024-01-20T00:00:00,4302,198,113,194,41213569,12655029,480461,,12174568,7703540
3935,2024-01-21T00:00:00,2027,88,58,105,41215596,12654834,480487,,12174347,7703402
3936,2024-01-22T00:00:00,832,41,17,49,41216428,12654601,480510,,12174091,7703214
3937,2024-01-23T00:00:00,3060,97,49,126,41219488,12654374,480553,,12173821,7703067
3938,2024-01-24T00:00:00,2797,122,52,134,41222285,12654215,480618,,12173597,7702959
3939,2024-01-25T00:00:00,2903,139,94,137,41225188,12654019,480659,,12173360,7702795
3940,2024-01-26T00:00:00,2984,112,53,109,41228172,12653840,480715,,12173125,7702651
3941,2024-01-27T00:00:00,3049,108,95,149,41231221,12653642,480726,,12172916,7702528
3942,2024-01-28T00:00:00,1549,75,46,90,41232770,12653406,480753,,12172653,7702339
3943,2024-01-29T00:00:00,632,25,10,42,41233402,12653118,480762,,12172356,7702107
3944,2024-01-30T00:00:00,2360,94,56,109,41235762,12652894,480796,,12172098,7701955
3945,2024-01-31T00:00:00,2576,103,64,126,41238338,12652713,480835,,12171878,7701826
3946,2024-02-01T00:00:00,2599,108,55,97,41240937,12652488,480878,,12171610,7701636
3947,2024-02-02T00:00:00,2167,79,54,93,41243104,12652262,480899,,12171363,7701459
3948,2024-02-03T00:00:00,2667,100,79,100,41245771,12652057,480918,,12171139,7701286
3949,2024-02-04T00:00:00,1158,65,27,62,41246929,12651857,480952,,12170905,7701114
3950,2024-02-05T00:00:00,616,39,17,27,41247545,12651604,480969,,12170635,7700889
3951,2024-02-06T00:00:00,2059,94,49,84,41249604,12651387,481009,,12170378,7700708
3952,2024-02-07T00:00:00,2039,70,59,80,41251643,12651173,481015,,12170158,7700539
3953,2024-02-08T00:00:00,2013,88,73,111,41253656,12650965,481030,,12169935,7700398
3954,2024-02-09T00:00:00,2013,75,56,91,41255669,12650749,481044,,12169705,7700249
3955,2024-02-10T00:00:00,2161,95,84,96,41257830,12650515,481051,,12169464,7700064
3956,2024-02-11T00:00:00,1026,48,31,39,41258856,12650295,481066,,12169229,7699873
3957,2024-02-12T00:00:00,409,20,6,25,41259265,12650051,481075,,12168976,7699669
3958,2024-02-13T00:00:00,1741,69,38,77,41261006,12649820,481104,,12168716,7699484
3959,2024-02-14T00:00:00,1555,61,48,81,41262561,12649583,481116,,12168467,7699299
3960,2024-02-15T00:00:00,1395,50,53,85,41263956,12649316,481110,,12168206,7699103
3961,2024-02-16T00:00:00,1293,71,39,55,41265249,12649078,481139,,12167939,7698893
3962,2024-02-17T00:00:00,1940,88,52,103,41267189,12648879,481172,,12167707,7698745
3963,2024-02-18T00:00:00,733,49,16,50,41267922,12648638,481200,,12167438,7698544
3964,2024-02-19T00:00:00,356,23,4,25,41268278,12648385,481213,,12167172,7698342
3965,2024-02-20T00:00:00,342,15,5,19,41268620,12648108,481219,,12166889,7698107
3966,2024-02-21T00:00:00,1577,94,43,75,41270197,12647899,481266,,12166633,7697904
3967,2024-02-22T00:00:00,1519,76,42,76,41271716,12647648,481299,,12166349,7697701
3968,2024-02-23T00:00:00,1546,82,45,71,41273262,12647394,481328,,12166066,7697478
3969,2024-02-24T00:00:00,1744,85,59,96,41275006,12647159,481349,,12165810,7697290
3970,2024-02-25T00:00:00,700,27,21,52,41275706,12646919,481354,,12165565,7697121
3971,2024-02-26T00:00:00,391,14,3,38,41276097,12646660,481360,,12165300,7696928
3972,2024-02-27T00:00:00,1400,64,56,68,41277497,12646422,481364,,12165058,7696729
3973,2024-02-28T00:00:00,1219,72,31,66,41278716,12646172,481401,,12164771,7696518
3974,2024-02-29T00:00:00,1184,67,51,74,41279900,12645946,481413,,12164533,7696341
3975,2024-03-01T00:00:00,1158,78,36,69,41281058,12645718,481454,,12164264,7696144
3976,2024-03-02T00:00:00,1495,71,29,69,41282553,12645484,481489,,12163995,7695954
3977,2024-03-03T00:00:00,697,29,13,35,41283250,12645212,481504,,12163708,7695722
3978,2024-03-04T00:00:00,348,14,5,22,41283598,12644940,481508,,12163432,7695505
3979,2024-03-05T00:00:00,1138,52,25,64,41284736,12644687,481529,,12163158,7695309
3980,2024-03-06T00:00:00,1192,54,37,49,41285928,12644442,481545,,12162897,7695093
3981,2024-03-07T00:00:00,1259,43,37,55,41287187,12644159,481546,,12162613,7694864
3982,2024-03-08T00:00:00,1083,59,26,51,41288270,12643927,481577,,12162350,7694662
3983,2024-03-09T00:00:00,1233,74,24,65,41289503,12643717,481624,,12162093,7694488
3984,2024-03-10T00:00:00,678,28,10,36,41290181,12643441,481634,,12161807,7694267
3985,2024-03-11T00:00:00,278,15,5,19,41290459,12643228,481641,,12161587,7694077
3986,2024-03-12T00:00:00,1097,58,38,47,41291556,12642986,481657,,12161329,7693858
3987,2024-03-13T00:00:00,1071,54,18,62,41292627,12642770,481692,,12161078,7693692
3988,2024-03-14T00:00:00,1063,43,33,55,41293690,12642492,481697,,12160795,7693477
3989,2024-03-15T00:00:00,1186,51,20,47,41294876,12642255,481725,,12160530,7693282
3990,2024-03-16T00:00:00,1279,54,34,55,41296155,12641996,481742,,12160254,7693060
3991,2024-03-17T00:00:00,518,21,8,40,41296673,12641743,481750,,12159993,7692866
3992,2024-03-18T00:00:00,205,11,3,19,41296878,12641457,481754,,12159703,7692624
3993,2024-03-19T00:00:00,994,38,22,51,41297872,12641200,481768,,12159432,7692419
3994,2024-03-20T00:00:00,895,38,25,52,41298767,12640946,481776,,12159170,7692218
3995,2024-03-21T00:00:00,971,40,32,41,41299738,12640696,481782,,12158914,7692005
3996,2024-03-22T00:00:00,978,52,27,51,41300716,12640474,481803,,12158671,7691809
3997,2024-03-23T00:00:00,1010,45,33,58,41301726,12640232,481808,,12158424,7691625
3998,2024-03-24T00:00:00,433,26,13,23,41302159,12639985,481819,,12158166,7691407
3999,2024-03-25T00:00:00,223,9,4,22,41302382,12639700,481819,,12157881,7691177
4000,2024-03-26T00:00:00,1010,59,30,54,41303392,12639468,481844,,12157624,7690980
4001,2024-03-27T00:00:00,795,41,23,50,41304187,12639221,481857,,12157364,7690773
4002,2024-03-28T00:00:00,851,42,27,48,41305038,12638936,481868,,12157068,7690538
4003,2024-03-29T00:00:00,1006,51,31,34,41306044,12638692,481884,,12156808,7690315
4004,2024-03-30T00:00:00,232,11,2,14,41306276,12638406,481887,,12156519,7690068
4005,2024-03-31T00:00:00,349,17,11,27,41306625,12638143,481892,,12156251,7689855
4006,2024-04-01T00:00:00,89,5,2,6,41306714,12637901,481891,,12156010,7689646
4007,2024-04-02T00:00:00,674,27,10,32,41307388,12637651,481905,,12155746,7689443
4008,2024-04-03T00:00:00,967,46,20,42,41308355,12637396,481926,,12155470,7689225
4009,2024-04-04T00:00:00,941,51,30,37,41309296,12637165,481939,,12155226,7689021
4010,2024-04-05T00:00:00,1035,39,16,25,41310331,12636906,481959,,12154947,7688783
4011,2024-04-06T00:00:00,1192,50,32,49,41311523,12636650,481976,,12154674,7688559
4012,2024-04-07T00:00:00,559,31,19,26,41312082,12636422,481986,,12154436,7688356
4013,2024-04-08T00:00:00,373,10,2,13,41312455,12636162,481990,,12154172,7688145
4014,2024-04-09T00:00:00,980,31,15,40,41313435,12635905,482004,,12153901,7687931
4015,2024-04-10T00:00:00,1288,36,26,22,41314723,12635662,482010,,12153652,7687711
4016,2024-04-11T00:00:00,1495,54,27,43,41316218,12635416,482034,,12153382,7687493
4017,2024-04-12T00:00:00,1252,34,25,36,41317470,12635156,482040,,12153116,7687268
4018,2024-04-13T00:00:00,1577,39,17,47,41319047,12634911,482058,,12152853,7687067
4019,2024-04-14T00:00:00,746,28,17,16,41319793,12634674,482066,,12152608,7686848
4020,2024-04-15T00:00:00,424,9,3,12,41320217,12634413,482065,,12152348,7686636
4021,2024-04-16T00:00:00,1790,36,24,30,41322007,12634148,482075,,12152073,7686402
4022,2024-04-17T00:00:00,1778,50,19,48,41323785,12633931,482102,,12151829,7686226
4023,2024-04-18T00:00:00,1985,49,34,47,41325770,12633700,482114,,12151586,7686036
4024,2024-04-19T00:00:00,2102,50,32,35,41327872,12633438,482130,,12151308,7685801
4025,2024-04-20T00:00:00,1835,48,25,56,41329707,12633172,482147,,12151025,7685594
4026,2024-04-21T00:00:00,754,14,17,29,41330461,12632915,482139,,12150776,7685383
4027,2024-04-22T00:00:00,341,7,2,10,41330802,12632667,482137,,12150530,7685184
4028,2024-04-23T00:00:00,2217,54,17,47,41333019,12632451,482170,,12150281,7685006
4029,2024-04-24T00:00:00,2248,44,20,43,41335267,12632195,482189,,12150006,7684789
4030,2024-04-25T00:00:00,2175,31,23,50,41337442,12631972,482193,,12149779,7684609
4031,2024-04-26T00:00:00,2717,55,39,53,41340159,12631730,482203,,12149527,7684408
4032,2024-04-27T00:00:00,2565,46,33,48,41342724,12631467,482211,,12149256,7684191
4033,2024-04-28T00:00:00,965,26,12,24,41343689,12631251,482222,,12149029,7684012
4034,2024-04-29T00:00:00,293,3,4,6,41343982,12631010,482217,,12148793,7683817
4035,2024-04-30T00:00:00,2427,51,29,34,41346409,12630782,482237,,12148545,7683603
4036,2024-05-01T00:00:00,2671,56,22,46,41349080,12630586,482268,,12148318,7683439
4037,2024-05-02T00:00:00,3264,38,19,72,41352344,12630344,482286,,12148058,7683267
4038,2024-05-03T00:00:00,3079,46,28,39,41355423,12630110,482303,,12147807,7683069
4039,2024-05-04T00:00:00,3946,58,33,35,41359369,12629891,482323,,12147568,7682873
4040,2024-05-05T00:00:00,1501,15,10,21,41360870,12629669,482326,,12147343,7682697
4041,2024-05-06T00:00:00,680,8,2,9,41361550,12629411,482328,,12147083,7682479
4042,2024-05-07T00:00:00,4604,48,21,45,41366154,12629202,482354,,12146848,7682301
4043,2024-05-08T00:00:00,5601,51,25,44,41371755,12629002,482377,,12146625,7682129
4044,2024-05-09T00:00:00,5838,22,31,59,41377593,12628737,482367,,12146370,7681932
4045,2024-05-10T00:00:00,7195,55,34,67,41384788,12628539,482385,,12146154,7681779
4046,2024-05-11T00:00:00,6730,52,28,58,41391518,12628324,482404,,12145920,7681613
4047,2024-05-12T00:00:00,1863,17,8,17,41393381,12628072,482409,,12145663,7681392
4048,2024-05-13T00:00:00,694,4,3,5,41394075,12627840,482409,,12145431,7681193
4049,2024-05-14T00:00:00,6074,40,24,44,41400149,12627586,482423,,12145163,7680975
4050,2024-05-15T00:00:00,8693,49,34,58,41408842,12627356,482432,,12144924,7680797
4051,2024-05-16T00:00:00,7548,51,28,58,41416390,12627107,482451,,12144656,7680596
4052,2024-05-17T00:00:00,8904,60,43,76,41425294,12626891,482465,,12144426,7680438
4053,2024-05-18T00:00:00,7700,52,27,55,41432994,12626677,482488,,12144189,7680265
4054,2024-05-19T00:00:00,2300,26,4,10,41435294,12626458,482506,,12143952,7680072
4055,2024-05-20T00:00:00,1002,6,3,14,41436296,12626221,482508,,12143713,7679876
4056,2024-05-21T00:00:00,945,6,2,8,41437241,12625980,482509,,12143471,7679676
4057,2024-05-22T00:00:00,7213,50,35,61,41444454,12625755,482519,,12143236,7679493
4058,2024-05-23T00:00:00,7548,38,26,59,41452002,12625539,482527,,12143012,7679339
4059,2024-05-24T00:00:00,7547,46,28,64,41459549,12625347,482540,,12142807,7679199
4060,2024-05-25T00:00:00,6005,66,31,50,41465554,12625180,482572,,12142608,7679050
4061,2024-05-26T00:00:00,1544,17,6,21,41467098,12624970,482581,,12142389,7678874
4062,2024-05-27T00:00:00,794,11,0,9,41467892,12624762,482592,,12142170,7678692
4063,2024-05-28T00:00:00,6200,54,27,60,41474092,12624547,482614,,12141933,7678513
4064,2024-05-29T00:00:00,7158,45,31,73,41481250,12624361,482628,,12141733,7678373
4065,2024-05-30T00:00:00,6923,58,35,60,41488173,12624202,482650,,12141552,7678246
4066,2024-05-31T00:00:00,6938,49,29,73,41495111,12624027,482666,,12141361,7678117
4067,2024-06-01T00:00:00,5905,56,26,44,41501016,12623856,482695,,12141161,7677959
4068,2024-06-02T00:00:00,1470,19,9,26,41502486,12623684,482704,,12140980,7677817
4069,2024-06-03T00:00:00,507,3,3,7,41502993,12623462,482703,,12140759,7677630
4070,2024-06-04T00:00:00,4736,57,23,50,41507729,12623264,482733,,12140531,7677460
4071,2024-06-05T00:00:00,5132,64,25,46,41512861,12623073,482770,,12140303,7677289
4072,2024-06-06T00:00:00,5541,37,36,55,41518402,12622890,482770,,12140120,7677148
4073,2024-06-07T00:00:00,5887,39,24,61,41524289,12622652,482782,,12139870,7676976
4074,2024-06-08T00:00:00,4959,66,47,60,41529248,12622477,482796,,12139681,7676821
4075,2024-06-09T00:00:00,1195,11,19,25,41530443,12622274,482786,,12139488,7676659
4076,2024-06-10T00:00:00,513,5,5,4,41530956,12622063,482786,,12139277,7676464
4077,2024-06-11T00:00:00,3994,34,28,47,41534950,12621875,482790,,12139085,7676319
4078,2024-06-12T00:00:00,4869,53,24,50,41539819,12621685,482816,,12138869,7676151
4079,2024-06-13T00:00:00,4606,61,35,59,41544425,12621519,482838,,12138681,7676014
4080,2024-06-14T00:00:00,4071,53,28,49,41548496,12621331,482858,,12138473,7675851
4081,2024-06-15T00:00:00,3783,60,27,57,41552279,12621151,482889,,12138262,7675698
4082,2024-06-16T00:00:00,840,17,8,16,41553119,12620928,482892,,12138036,7675510
4083,2024-06-17T00:00:00,296,2,7,9,41553415,12620738,482886,,12137852,7675354
4084,2024-06-18T00:00:00,2932,44,21,32,41556347,12620525,482909,,12137616,7675163
4085,2024-06-19T00:00:00,3728,47,30,57,41560075,12620328,482921,,12137407,7675014
4086,2024-06-20T00:00:00,3808,46,24,48,41563883,12620133,482938,,12137195,7674855
4087,2024-06-21T00:00:00,3923,40,37,50,41567806,12619934,482935,,12136999,7674704
4088,2024-06-22T00:00:00,3103,48,23,44,41570909,12619753,482958,,12136795,7674548
4089,2024-06-23T00:00:00,914,17,8,11,41571823,12619529,482963,,12136566,7674343
4090,2024-06-24T00:00:00,352,2,5,11,41572175,12619293,482959,,12136334,7674154
4091,2024-06-25T00:00:00,2756,54,29,48,41574931,12619084,482982,,12136102,7673984
4092,2024-06-26T00:00:00,3198,57,23,48,41578129,12618880,483014,,12135866,7673797
4093,2024-06-27T00:00:00,3290,48,34,37,41581419,12618659,483027,,12135632,7673598
4094,2024-06-28T00:00:00,3385,55,16,56,41584804,12618440,483064,,12135376,7673423
4095,2024-06-29T00:00:00,2889,50,12,39,41587693,12618223,483097,,12135126,7673239
4096,2024-06-30T00:00:00,744,14,11,16,41588437,12618011,483099,,12134912,7673055
4097,2024-07-01T00:00:00,304,4,0,6,41588741,12617802,483098,,12134704,7672888
4098,2024-07-02T00:00:00,188,0,1,5,41588929,12617554,483094,,12134460,7672683
4099,2024-07-03T00:00:00,1993,47,19,33,41590922,12617365,483118,,12134247,7672516
4100,2024-07-04T00:00:00,2186,45,21,33,41593108,12617112,483138,,12133974,7672282
4101,2024-07-05T00:00:00,2339,35,16,47,41595447,12616863,483154,,12133709,7672085
4102,2024-07-06T00:00:00,2388,59,24,34,41597835,12616654,483186,,12133468,7671884
4103,2024-07-07T00:00:00,577,28,9,16,41598412,12616454,483203,,12133251,7671696
4104,2024-07-08T00:00:00,284,6,3,8,41598696,12616213,483204,,12133009,7671489
4105,2024-07-09T00:00:00,1676,49,14,40,41600372,12616000,483237,,12132763,7671296
4106,2024-07-10T00:00:00,1640,29,19,43,41602012,12615769,483244,,12132525,7671119
4107,2024-07-11T00:00:00,1486,52,16,29,41603498,12615548,483277,,12132271,7670902
4108,2024-07-12T00:00:00,1665,52,27,39,41605163,12615344,483298,,12132046,7670714
4109,2024-07-13T00:00:00,1438,47,12,24,41606601,12615148,483329,,12131819,7670526
4110,2024-07-14T00:00:00,500,18,11,21,41607101,12614930,483334,,12131596,7670341
4111,2024-07-15T00:00:00,297,10,3,14,41607398,12614710,483340,,12131370,7670153
4112,2024-07-16T00:00:00,1257,34,14,32,41608655,12614486,483356,,12131130,7669955
4113,2024-07-17T00:00:00,1378,56,29,35,41610033,12614310,483383,,12130927,7669800
4114,2024-07-18T00:00:00,1244,51,14,38,41611277,12614080,483414,,12130666,7669598
4115,2024-07-19T00:00:00,1674,45,19,30,41612951,12613873,483440,,12130433,7669408
4116,2024-07-20T00:00:00,1554,34,19,23,41614505,12613676,483453,,12130223,7669227
4117,2024-07-21T00:00:00,468,15,5,13,41614973,12613455,483460,,12129995,7669037
4118,2024-07-22T00:00:00,218,4,3,13,41615191,12613230,483458,,12129772,7668856
4119,2024-07-23T00:00:00,1296,51,23,32,41616487,12613020,483485,,12129535,7668665
4120,2024-07-24T00:00:00,1485,35,29,36,41617972,12612795,483487,,12129308,7668475
4121,2024-07-25T00:00:00,1400,49,11,33,41619372,12612598,483525,,12129073,7668297
4122,2024-07-26T00:00:00,1406,41,17,39,41620778,12612368,483544,,12128824,7668097
4123,2024-07-27T00:00:00,1177,38,17,29,41621955,12612161,483563,,12128598,7667906
4124,2024-07-28T00:00:00,497,20,7,22,41622452,12611946,483575,,12128371,7667725
4125,2024-07-29T00:00:00,257,9,3,5,41622709,12611764,483578,,12128186,7667565
4126,2024-07-30T00:00:00,1329,40,15,31,41624038,12611545,483599,,12127946,7667371
4127,2024-07-31T00:00:00,1420,49,16,37,41625458,12611368,483630,,12127738,7667209
4128,2024-08-01T00:00:00,1233,45,13,27,41626691,12611178,483659,,12127519,7667030
4129,2024-08-02T00:00:00,1209,45,15,23,41627900,12610988,483688,,12127300,7666850
4130,2024-08-03T00:00:00,1061,31,10,28,41628961,12610799,483706,,12127093,7666687
4131,2024-08-04T00:00:00,437,8,4,9,41629398,12610565,483709,,12126856,7666490
4132,2024-08-05T00:00:00,226,8,1,7,41629624,12610375,483713,,12126662,7666331
4133,2024-08-06T00:00:00,245,2,4,12,41629869,12610161,483708,,12126453,7666150
4134,2024-08-07T00:00:00,1127,34,13,22,41630996,12609984,483726,,12126258,7665998
4135,2024-08-08T00:00:00,1090,38,25,23,41632086,12609788,483737,,12126051,7665816
4136,2024-08-09T00:00:00,1228,43,21,47,41633314,12609593,483752,,12125841,7665663
4137,2024-08-10T00:00:00,1285,47,17,31,41634599,12609438,483779,,12125659,7665520
4138,2024-08-11T00:00:00,507,23,5,10,41635106,12609262,483796,,12125466,7665359
4139,2024-08-12T00:00:00,219,6,0,4,41635325,12609088,483801,,12125287,7665202
4140,2024-08-13T00:00:00,1161,39,12,35,41636486,12608925,483826,,12125099,7665063
4141,2024-08-14T00:00:00,1216,35,12,42,41637702,12608756,483844,,12124912,7664932
4142,2024-08-15T00:00:00,1065,39,19,30,41638767,12608580,483863,,12124717,7664774
4143,2024-08-16T00:00:00,1129,37,11,46,41639896,12608427,483888,,12124539,7664656
4144,2024-08-17T00:00:00,1086,38,24,31,41640982,12608279,483900,,12124379,7664527
4145,2024-08-18T00:00:00,450,15,3,12,41641432,12608108,483911,,12124197,7664381
4146,2024-08-19T00:00:00,223,5,3,6,41641655,12607927,483911,,12124016,7664216
4147,2024-08-20T00:00:00,1155,39,22,31,41642810,12607781,483928,,12123853,7664082
4148,2024-08-21T00:00:00,1179,37,15,27,41643989,12607661,483949,,12123712,7663970
4149,2024-08-22T00:00:00,1022,27,18,34,41645011,12607541,483957,,12123584,7663879
4150,2024-08-23T00:00:00,978,43,15,28,41645989,12607441,483984,,12123457,7663786
4151,2024-08-24T00:00:00,986,41,12,18,41646975,12607323,484012,,12123311,7663665
4152,2024-08-25T00:00:00,360,10,14,16,41647335,12607189,484005,,12123184,7663554
4153,2024-08-26T00:00:00,197,8,1,7,41647532,12607040,484012,,12123028,7663426
4154,2024-08-27T00:00:00,1035,51,13,29,41648567,12606919,484048,,12122871,7663302
4155,2024-08-28T00:00:00,1000,50,18,33,41649567,12606823,484079,,12122744,7663210
4156,2024-08-29T00:00:00,841,37,17,27,41650408,12606740,484098,,12122642,7663134
4157,2024-08-30T00:00:00,818,40,13,37,41651226,12606676,484123,,12122553,7663080
4158,2024-08-31T00:00:00,712,31,7,20,41651938,12606584,484146,,12122438,7662988
4159,2024-09-01T00:00:00,363,16,6,14,41652301,12606478,484153,,12122325,7662892
4160,2024-09-02T00:00:00,2,1,0,0,41652303,12606366,484151,,12122215,7662796
4161,2024-09-03T00:00:00,5,1,0,1,41652308,12606251,484151,,12122100,7662696
4162,2024-09-04T00:00:00,24,0,1,3,41652332,12606106,484148,,12121958,7662573
4163,2024-09-05T00:00:00,12,2,0,0,41652344,12605967,484150,,12121817,7662448
4164,2024-09-06T00:00:00,4,1,0,0,41652348,12605816,484149,,12121667,7662309
4165,2024-09-07T00:00:00,9,1,0,1,41652357,12605672,484149,,12121523,7662187
4166,2024-09-08T00:00:00,3,0,0,0,41652360,12605542,484148,,12121394,7662074
4167,2024-09-09T00:00:00,1,0,0,0,41652361,12605389,484145,,12121244,7661937
4168,2024-09-10T00:00:00,4,0,0,0,41652365,12605224,484143,,12121081,7661789
4169,2024-09-11T00:00:00,2,0,0,0,41652367,12605027,484142,,12120885,7661613
4170,2024-09-12T00:00:00,3,1,0,0,41652370,12604810,484141,,12120669,7661426
4171,2024-09-13T00:00:00,2,0,0,1,41652372,12604588,484139,,12120449,7661231
4172,2024-09-14T00:00:00,7,0,0,0,41652379,12604362,484136,,12120226,7661037
4173,2024-09-15T00:00:00,,,,,41652379,12604174,484135,,12120039,7660873
4174,2024-09-16T00:00:00,1,0,0,0,41652380,12603949,484133,,12119816,7660676
4175,2024-09-17T00:00:00,4,1,0,0,41652384,12603728,484131,,12119597,7660476
4176,2024-09-18T00:00:00,,,,,41652384,12603502,484129,,12119373,7660282
4177,2024-09-19T00:00:00,2,0,0,1,41652386,12603276,484126,,12119150,7660082
4178,2024-09-20T00:00:00,,,,,41652386,12603059,484124,,12118935,7659891
4179,2024-09-21T00:00:00,5,0,0,0,41652391,12602853,484123,,12118730,7659706
4180,2024-09-22T00:00:00,5,0,2,0,41652396,12602644,484120,,12118524,7659523
4181,2024-09-23T00:00:00,4,0,0,0,41652400,12602441,484118,,12118323,7659348
4182,2024-09-24T00:00:00,2,1,0,0,41652402,12602235,484119,,12118116,7659169
4183,2024-09-25T00:00:00,4,0,0,0,41652406,12602022,484117,,12117905,7658977
4184,2024-09-26T00:00:00,1,0,0,1,41652407,12601822,484115,,12117707,7658795
4185,2024-09-27T00:00:00,1,0,0,0,41652408,12601642,484113,,12117529,7658638
4186,2024-09-28T00:00:00,,,,,41652408,12601461,484110,,12117351,7658482
4187,2024-09-29T00:00:00,4,0,0,0,41652412,12601271,484107,,12117164,7658314
4188,2024-09-30T00:00:00,2,1,0,0,41652414,12601077,484105,,12116972,7658147
4189,2024-10-01T00:00:00,1156,18,7,6,41653570,12600901,484114,,12116787,7657980
4190,2024-10-02T00:00:00,2145,16,15,11,41655715,12600690,484111,,12116579,7657797
4191,2024-10-03T00:00:00,2751,35,9,11,41658466,12600531,484135,,12116396,7657632
4192,2024-10-04T00:00:00,4575,39,23,26,41663041,12600383,484150,,12116233,7657492
4193,2024-10-05T00:00:00,5579,61,33,33,41668620,12600247,484177,,12116070,7657356
4194,2024-10-06T00:00:00,3158,32,12,39,41671778,12600103,484197,,12115906,7657241
4195,2024-10-07T00:00:00,1613,13,10,12,41673391,12599927,484198,,12115729,7657083
4196,2024-10-08T00:00:00,8125,66,30,63,41681516,12599796,484233,,12115563,7656966
4197,2024-10-09T00:00:00,8619,97,37,50,41690135,12599725,484291,,12115434,7656867
4198,2024-10-10T00:00:00,9230,101,50,58,41699365,12599634,484340,,12115294,7656760
4199,2024-10-11T00:00:00,10197,104,56,88,41709562,12599532,484387,,12115145,7656667
4200,2024-10-12T00:00:00,10107,127,52,114,41719669,12599448,484460,,12114988,7656587
4201,2024-10-13T00:00:00,3863,71,26,47,41723532,12599353,484505,,12114848,7656486
4202,2024-10-14T00:00:00,1850,32,22,34,41725382,12599225,484515,,12114710,7656377
4203,2024-10-15T00:00:00,1467,21,10,18,41726849,12599065,484524,,12114541,7656238
4204,2024-10-16T00:00:00,23294,256,127,219,41750143,12599133,484651,,12114482,7656291
4205,2024-10-17T00:00:00,28096,262,125,239,41778239,12599213,484786,,12114427,7656373
4206,2024-10-18T00:00:00,31964,304,162,251,41810203,12599328,484926,,12114402,7656457
4207,2024-10-19T00:00:00,32173,358,166,326,41842376,12599487,485116,,12114371,7656616
4208,2024-10-20T00:00:00,14705,202,113,194,41857081,12599542,485204,,12114338,7656683
4209,2024-10-21T00:00:00,8027,97,56,88,41865108,12599443,485244,,12114199,7656596
4210,2024-10-22T00:00:00,33762,316,159,281,41898870,12599585,485401,,12114184,7656715
4211,2024-10-23T00:00:00,34676,329,147,307,41933546,12599732,485583,,12114149,7656855
4212,2024-10-24T00:00:00,33821,355,185,351,41967367,12599927,485751,,12114176,7657065
4213,2024-10-25T00:00:00,34481,351,186,378,42001848,12600124,485915,,12114209,7657308
4214,2024-10-26T00:00:00,31949,380,186,357,42033797,12600359,486109,,12114250,7657532
4215,2024-10-27T00:00:00,13210,184,125,226,42047007,12600386,486166,,12114220,7657623
4216,2024-10-28T00:00:00,7954,88,48,140,42054961,12600332,486206,,12114126,7657633
4217,2024-10-29T00:00:00,38210,466,229,387,42093171,12600621,486441,,12114180,7657860
4218,2024-10-30T00:00:00,42656,505,235,453,42135827,12600981,486710,,12114271,7658180
4219,2024-10-31T00:00:00,42467,505,224,473,42178294,12601343,486990,,12114353,7658527
4220,2024-11-01T00:00:00,42312,498,240,387,42220606,12601695,487246,,12114449,7658785
4221,2024-11-02T00:00:00,46299,618,286,590,42266905,12602202,487577,,12114625,7659278
4222,2024-11-03T00:00:00,23431,440,215,486,42290336,12602536,487801,,12114735,7659670
4223,2024-11-04T00:00:00,12489,203,123,259,42302825,12602626,487880,,12114746,7659830
4224,2024-11-05T00:00:00,41893,544,245,492,42344718,12603040,488178,,12114862,7660210
4225,2024-11-06T00:00:00,43919,593,295,627,42388637,12603532,488476,,12115056,7660749
4226,2024-11-07T00:00:00,40063,537,265,607,42428700,12603967,488747,,12115220,7661269
4227,2024-11-08T00:00:00,42910,663,331,630,42471610,12604523,489078,,12115445,7661807
4228,2024-11-09T00:00:00,39541,620,290,647,42511151,12605041,489408,,12115633,7662362
4229,2024-11-10T00:00:00,19479,389,193,520,42530630,12605350,489604,,12115746,7662809
4230,2024-11-11T00:00:00,10407,220,78,253,42541037,12605489,489745,,12115744,7662985
4231,2024-11-12T00:00:00,31457,477,228,504,42572494,12605887,489994,,12115893,7663425
4232,2024-11-13T00:00:00,34562,477,226,562,42607056,12606292,490245,,12116047,7663922
4233,2024-11-14T00:00:00,33408,512,242,542,42640464,12606752,490515,,12116237,7664420
4234,2024-11-15T00:00:00,33883,472,217,553,42674347,12607190,490770,,12116420,7664942
4235,2024-11-16T00:00:00,34077,585,258,549,42708424,12607766,491097,,12116669,7665482
4236,2024-11-17T00:00:00,15527,316,161,360,42723951,12608082,491252,,12116830,7665842
4237,2024-11-18T00:00:00,8158,173,101,221,42732109,12608255,491324,,12116931,7666063
4238,2024-11-19T00:00:00,28335,454,157,387,42760444,12608709,491621,,12117088,7666450
4239,2024-11-20T00:00:00,25785,323,138,376,42786229,12609032,491806,,12117226,7666826
